Symbol,ATR M,Stop loss,Candle B,Limit,Start,End,SL,TP,MOC,Trades,SL trail,Min TP,Profits,Losses,P/L,Avg TP,Max profit,Max loss,Grand
A,1.03,0.49,0.04,0.01,20101028,20110805,3,6,34,43,0,20,26,17,1.53,1.73,1.22,-0.50,6446.70
D,0.55,0.49,0.01,0.01,20100706,20110805,1,3,78,82,0,82,47,35,1.34,2.88,0.74,-0.49,4314.40
F,0.55,0.23,0.01,0.01,20100706,20110805,5,10,92,107,0,107,64,43,1.49,0.84,0.35,-0.24,5016.90
K,0.63,0.41,0.03,0.01,20101012,20110805,0,3,51,54,0,54,33,21,1.57,2.21,0.62,-0.35,3908.30
M,1.11,0.49,0.02,0.01,20100706,20110805,2,5,82,89,0,73,52,37,1.41,2.73,0.78,-0.55,6471.50
Q,0.55,0.27,0,0.01,20100706,20110805,0,0,97,97,0,97,58,39,1.49,0.00,0.14,-0.08,1383.60
T,0.55,0.37,0.01,0,20100706,20110805,0,2,69,71,0,71,41,30,1.37,2.82,0.56,-0.20,3568.00
V,0.79,0.47,0.02,0.01,20100706,20110805,16,14,53,83,0,39,52,31,1.68,1.87,1.26,-0.48,15702.20
X,0.63,0.49,0,-0.01,20100706,20110805,18,24,47,89,0,64,59,30,1.97,1.25,1.40,-0.48,18719.00
AA,0.91,0.23,0.03,0,20100706,20110805,4,6,53,63,0,52,42,21,2.00,0.94,0.43,-0.23,3703.90
BA,0.79,0.31,0.03,-0.05,20100706,20110805,29,20,22,71,0,12,42,29,1.45,1.02,1.33,-0.28,12803.80
BK,0.63,0.37,0.01,0.01,20100706,20110805,4,4,42,50,0,50,30,20,1.50,1.73,0.56,-0.38,3394.90
BP,0.55,0.33,0,0.01,20100706,20110805,22,19,70,111,0,88,69,42,1.64,0.97,0.71,-0.34,8301.50
BX,0.71,0.25,0.01,0.02,20101028,20110805,6,13,61,80,0,71,52,28,1.86,0.71,0.43,-0.27,5955.20
CA,0.87,0.23,0.01,0.01,20100706,20110805,10,11,55,76,0,59,40,36,1.11,0.62,0.42,-0.24,2588.00
CB,0.55,0.47,0.04,0.02,20101028,20110805,2,5,47,54,0,54,27,27,1.00,1.62,0.71,-0.49,3810.80
CF,0.67,0.43,0,-0.01,20101028,20110805,47,36,12,95,0,27,47,48,0.98,1.51,3.51,-0.49,34401.90
CI,0.91,0.39,0.02,0.01,20101028,20110805,3,7,53,63,0,39,44,19,2.32,1.92,1.04,-0.40,10246.10
CL,0.55,0.39,0,0.01,20101028,20110805,9,13,44,66,0,66,46,20,2.30,1.04,0.59,-0.40,8843.20
CX,0.55,0.25,0.02,0.02,20100706,20110805,3,2,87,92,0,92,57,35,1.63,2.75,0.38,-0.27,2202.00
CY,0.55,0.49,0,-0.03,20101028,20110805,4,3,57,64,0,64,42,22,1.91,2.95,0.74,-0.46,5208.00
DD,0.67,0.31,0.03,0.02,20100706,20110805,19,28,62,109,0,81,66,43,1.53,0.68,0.74,-0.33,10084.80
DE,0.59,0.41,0,0.01,20100706,20110805,29,25,25,79,0,37,42,37,1.14,1.01,1.48,-0.45,11805.30
DF,0.55,0.29,0,0.02,20101028,20110805,2,2,77,81,0,81,48,33,1.45,3.10,0.44,-0.30,3236.50
DG,1.03,0.45,0,0.01,20101028,20110805,3,6,68,77,0,62,54,23,2.35,1.97,0.82,-0.47,8467.40
DO,0.63,0.39,0,0.02,20100706,20110805,27,26,31,84,0,38,45,39,1.15,0.96,1.35,-0.46,12140.20
EK,0.55,0.45,0.02,0.01,20100706,20110805,0,1,74,75,0,75,51,24,2.13,3.77,0.68,-0.12,2432.60
EP,0.55,0.39,0,0.01,20100706,20110805,1,2,114,117,0,117,64,53,1.21,4.54,0.59,-0.40,2987.90
ES,0.55,0.27,0,0.01,20101025,20110805,0,2,91,93,0,93,55,38,1.45,2.47,0.41,-0.15,2713.90
FE,1.11,0.41,0.04,0.01,20101028,20110805,1,3,41,45,0,33,28,17,1.65,2.39,0.76,-0.42,4699.40
FL,0.55,0.33,0.03,0,20101028,20110805,4,3,37,44,0,44,28,16,1.75,1.66,0.50,-0.33,2571.50
GE,0.55,0.41,0.02,0.01,20100706,20110805,0,1,91,92,0,92,52,40,1.30,5.56,0.61,-0.26,1749.40
GG,0.75,0.49,0,0.01,20100706,20110805,15,14,56,85,0,65,49,36,1.36,1.36,1.19,-0.50,8085.30
GM,0.71,0.41,0.01,0,20101028,20110805,7,7,46,60,0,57,42,18,2.33,1.50,0.62,-0.41,6161.00
GS,0.87,0.39,0.01,-0.01,20100706,20110805,50,22,21,93,0,6,41,52,0.79,1.91,2.56,-0.41,22704.50
GT,0.79,0.27,0.03,0.01,20101028,20110805,2,6,37,45,0,39,31,14,2.21,0.99,0.50,-0.28,4525.00
HD,0.71,0.47,0,0.01,20100706,20110805,3,4,94,101,0,101,63,38,1.66,2.72,0.71,-0.48,5316.80
HK,1.07,0.25,0.01,0.02,20100706,20110805,19,14,45,78,0,15,48,30,1.60,0.95,0.87,-0.27,6473.50
HL,0.55,0.43,0.02,0.01,20100706,20110805,1,1,62,64,0,64,40,24,1.67,5.48,0.65,-0.44,3480.70
IP,0.91,0.43,0,0,20100706,20110805,4,6,68,78,0,63,42,36,1.17,2.05,0.70,-0.43,6641.50
IR,0.55,0.35,0.01,0.01,20100706,20110805,24,15,60,99,0,84,53,46,1.15,0.97,0.64,-0.36,3895.00
KG,0.55,0.27,0.02,-0.03,20100706,20110805,0,0,7,7,0,7,6,1,6.00,0.00,0.24,-0.05,692.00
KO,0.55,0.45,0.02,-0.01,20100706,20110805,2,5,63,70,0,70,44,26,1.69,1.86,0.68,-0.44,6208.60
KR,0.55,0.49,0,0.02,20100706,20110805,0,1,131,132,0,132,72,60,1.20,11.38,0.74,-0.33,3879.10
MF,0.55,0.21,0.01,0.01,20101028,20110805,0,3,80,83,0,83,51,32,1.59,1.56,0.32,-0.16,2319.10
MI,1.03,0.05,0.02,0.01,20100706,20110805,11,6,24,41,0,6,23,18,1.28,0.27,0.25,-0.06,786.80
MO,0.55,0.29,0.02,0.01,20100706,20110805,1,1,74,76,0,76,47,29,1.62,4.06,0.44,-0.30,1841.30
MS,0.91,0.23,0,0.01,20100706,20110805,29,25,63,117,0,58,69,48,1.44,0.69,0.65,-0.24,7945.10
MT,0.63,0.47,0.02,0.01,20100706,20110805,7,5,58,70,0,66,41,29,1.41,2.18,0.75,-0.48,4435.70
MU,0.55,0.29,0.03,0.01,20100706,20110805,1,2,59,62,0,62,38,24,1.58,2.45,0.44,-0.30,2903.80
NE,0.55,0.37,0.03,-0.02,20100706,20110805,15,12,36,63,0,55,35,28,1.25,0.95,0.65,-0.36,4451.70
NI,0.55,0.27,0.02,0.01,20101028,20110805,0,0,63,63,0,63,33,30,1.10,0.00,0.30,-0.21,1154.30
PG,0.71,0.39,0.02,0.02,20100706,20110805,9,11,76,96,0,94,52,44,1.18,1.30,0.59,-0.42,5867.50
PM,1.07,0.37,0,0.01,20100706,20110805,15,8,72,95,0,34,55,40,1.38,1.95,1.23,-0.38,6855.20
RF,0.55,0.21,0.01,0.02,20100706,20110805,3,1,106,110,0,110,70,40,1.75,4.98,0.32,-0.23,1460.20
SD,0.55,0.45,0.02,0.01,20100706,20110805,0,2,80,82,0,82,53,29,1.83,3.39,0.68,-0.39,3898.40
SE,0.55,0.45,0.02,0,20100706,20110805,0,1,66,67,0,67,38,29,1.31,5.54,0.68,-0.29,3030.00
SO,0.55,0.29,0.02,0.01,20100706,20110805,2,2,90,94,0,94,54,40,1.35,3.40,0.44,-0.30,2992.10
SU,1.07,0.49,0.02,0.01,20100706,20110805,9,9,61,79,0,26,49,30,1.63,2.09,1.30,-0.50,10901.00
TC,0.83,0.09,0.02,0.02,20101028,20110805,17,17,32,66,0,18,39,27,1.44,0.30,0.42,-0.11,2683.40
UN,0.55,0.39,0.03,0.02,20101028,20110805,0,0,55,55,0,55,35,20,1.75,0.00,0.36,-0.27,1290.00
VG,0.55,0.27,0.01,0,20100706,20110805,0,1,87,88,0,88,62,26,2.38,3.84,0.41,-0.21,2263.20
VZ,0.55,0.23,0.03,0.01,20100706,20110805,7,12,45,64,0,62,38,26,1.46,0.62,0.41,-0.24,4232.00
WL,0.87,0.15,0.01,0.02,20100706,20110805,6,10,74,90,0,67,54,36,1.50,0.55,0.35,-0.17,3298.20
WM,0.55,0.49,0.03,0.01,20101028,20110805,0,0,59,59,0,59,34,25,1.36,0.00,0.54,-0.23,3535.40
WU,0.55,0.29,0,-0.02,20100706,20110805,4,1,98,103,0,103,65,38,1.71,8.25,0.44,-0.27,4727.40
WY,0.55,0.41,0,0.01,20101028,20110805,3,5,68,76,0,76,48,28,1.71,2.15,0.62,-0.42,6540.80
XL,0.55,0.19,0.02,0.01,20100706,20110805,16,26,60,102,0,92,62,40,1.55,0.42,0.33,-0.20,5827.00
AAI,0.55,0.05,0,0.01,20101028,20110805,1,2,38,41,0,41,15,26,0.58,0.20,0.08,-0.06,-149.50
ABB,0.91,0.21,0.03,0.02,20101022,20110805,3,7,52,62,0,25,38,24,1.58,0.81,0.47,-0.24,3427.90
ABC,0.55,0.15,0.02,0.02,20100706,20110805,23,26,37,86,0,61,51,35,1.46,0.32,0.39,-0.18,3296.80
ABT,0.67,0.19,0,0,20100706,20110805,34,26,41,101,0,69,55,46,1.20,0.43,0.46,-0.20,3994.00
ABV,0.55,0.49,0.02,0.01,20101103,20110805,0,0,37,37,0,37,26,11,2.36,0.00,0.58,-0.26,3029.00
ABX,0.55,0.15,0,0,20100706,20110805,56,42,10,108,0,40,50,58,0.86,0.39,0.86,-0.16,7245.00
ACE,0.67,0.43,0.03,0.02,20100706,20110805,12,14,65,91,0,84,52,39,1.33,1.14,0.69,-0.45,6958.50
ACI,0.91,0.39,0.02,0,20100706,20110805,15,10,55,80,0,38,43,37,1.16,1.54,1.23,-0.39,7114.90
ACN,1.11,0.43,0.02,0.02,20100706,20110805,5,7,86,98,0,53,60,38,1.58,2.43,0.86,-0.45,10673.30
ADI,0.71,0.47,0,0.01,20100706,20110805,8,7,86,101,0,101,57,44,1.30,2.26,0.71,-0.48,7581.60
ADM,1.03,0.35,0.02,0.01,20100706,20110805,5,9,64,78,0,50,50,28,1.79,4.90,31.74,-0.36,38935.00
ADP,0.55,0.29,0.02,-0.01,20101028,20110805,4,5,38,47,0,46,29,18,1.61,1.14,0.45,-0.28,3545.70
AEO,0.63,0.27,0.02,0,20100706,20110805,4,6,58,68,0,68,43,25,1.72,1.10,0.41,-0.27,4024.70
AEP,0.83,0.27,0.02,0.01,20100706,20110805,2,5,72,79,0,70,50,29,1.72,1.46,0.56,-0.28,4808.00
AES,0.55,0.23,0,0.01,20100706,20110805,2,1,90,93,0,93,57,36,1.58,5.83,0.35,-0.24,2837.80
AET,0.71,0.41,0.01,0,20101028,20110805,3,6,43,52,0,45,32,20,1.60,1.46,0.96,-0.41,4296.90
AFL,0.63,0.31,0,0.01,20100706,20110805,28,21,27,76,0,40,40,36,1.11,0.83,1.10,-0.33,7702.60
AGO,1.11,0.43,0.03,0.01,20101028,20110805,2,1,54,57,0,45,38,19,2.00,8.13,0.71,-0.44,5060.70
AGU,1.03,0.41,0.01,-0.01,20101028,20110805,14,9,24,47,0,1,31,16,1.94,2.88,2.48,-0.43,19861.20
AIB,0.55,0.25,0.02,0.01,20100706,20110805,0,2,26,28,0,28,23,5,4.60,0.92,0.38,-0.02,1687.90
AKS,0.55,0.29,0.03,-0.03,20100706,20110805,9,9,36,54,0,53,39,15,2.60,0.90,0.44,-0.26,5075.40
ALL,0.55,0.27,0.03,0.01,20100706,20110805,14,14,56,84,0,80,55,29,1.90,0.80,0.41,-0.28,6052.00
AMD,0.67,0.21,0.02,0.01,20100706,20110805,5,5,70,80,0,80,58,22,2.64,1.05,0.32,-0.22,3180.30
AMP,0.55,0.41,0,0.01,20101028,20110805,12,19,32,63,0,56,45,18,2.50,0.91,0.70,-0.42,11413.00
AMR,1.03,0.17,0.01,0,20100706,20110805,4,4,59,67,0,50,41,26,1.58,0.96,0.32,-0.17,1917.80
AMT,0.67,0.27,0,0.01,20101028,20110805,15,12,35,62,0,38,38,24,1.58,0.72,0.83,-0.29,3769.00
AMX,1.11,0.37,0.01,-0.01,20100706,20110805,15,7,42,64,0,15,40,24,1.67,1.98,1.18,-0.38,7471.70
ANF,0.71,0.41,0.01,0,20100706,20110805,22,24,36,82,0,48,50,32,1.56,0.88,1.38,-0.42,11189.00
ANN,1.11,0.49,0.02,0.02,20101028,20110805,1,3,50,54,0,34,38,16,2.38,3.56,1.09,-0.51,7484.90
ANR,0.79,0.47,0.02,0.02,20100706,20110805,31,27,29,87,0,31,48,39,1.23,1.13,1.85,-0.50,13875.10
AON,0.55,0.49,0.01,0.01,20101028,20110805,1,4,59,64,0,64,46,18,2.56,2.72,0.74,-0.49,8027.80
APA,0.75,0.41,0,-0.02,20101028,20110805,17,15,9,41,0,12,23,18,1.28,1.24,2.36,-0.41,11576.00
APC,0.55,0.49,0.03,0.02,20100706,20110805,21,20,30,71,0,47,39,32,1.22,1.14,1.34,-0.52,10633.60
ARG,1.11,0.45,0.04,0.01,20101028,20110805,5,7,29,41,0,16,25,16,1.56,1.52,1.25,-0.47,6666.00
ARM,0.55,0.49,0.02,-0.04,20101028,20110805,1,2,21,24,0,24,20,4,5.00,2.81,0.74,-0.44,4959.00
ARO,0.63,0.49,0.03,0.01,20101028,20110805,0,2,60,62,0,62,38,24,1.58,3.73,0.74,-0.29,4506.40
AUO,0.55,0.49,0.01,0.01,20101028,20110805,0,0,71,71,0,71,34,37,0.92,0.00,0.26,-0.15,897.90
AUY,0.55,0.15,0.02,0.01,20100706,20110805,12,12,61,85,0,85,49,36,1.36,0.44,0.23,-0.16,2141.80
AVP,0.63,0.33,0.02,0,20100706,20110805,5,10,62,77,0,74,51,26,1.96,1.06,0.54,-0.33,6543.70
AXL,0.55,0.49,0,0.02,20101028,20110805,0,3,85,88,0,88,53,35,1.51,3.40,0.75,-0.39,5754.30
AXP,0.59,0.39,0.01,0,20100706,20110805,16,21,74,111,0,101,68,43,1.58,1.13,1.36,-0.39,13699.30
BAC,0.83,0.09,0.02,0.01,20100706,20110805,27,21,54,102,0,39,59,43,1.37,0.33,0.35,-0.10,3170.20
BAX,1.03,0.37,0.02,0.01,20100706,20110805,13,12,65,90,0,45,51,39,1.31,1.43,1.05,-0.38,9011.00
BBD,1.07,0.23,0,0.02,20100706,20110805,11,15,77,103,0,51,61,42,1.45,0.70,0.48,-0.25,5058.30
BBL,0.55,0.31,0.04,0.01,20100706,20110805,19,20,27,66,0,28,40,26,1.54,0.90,1.07,-0.67,10821.70
BBT,0.55,0.35,0.02,0.02,20100706,20110805,4,4,70,78,0,78,45,33,1.36,1.93,0.53,-0.37,3587.10
BBY,1.03,0.21,0.04,-0.01,20100706,20110805,23,12,46,81,0,14,51,30,1.70,1.16,1.18,-0.21,8678.70
BCS,0.55,0.45,0.04,-0.03,20101028,20110805,0,1,28,29,0,29,24,5,4.80,2.67,0.68,-0.13,2208.80
BEC,0.99,0.39,0.02,-0.02,20101028,20110805,3,3,14,20,0,5,16,4,4.00,1.61,1.14,-0.37,3653.20
BHI,0.71,0.43,0.02,0.02,20100706,20110805,28,23,38,89,0,43,45,44,1.02,1.24,1.43,-0.46,12794.00
BHP,0.55,0.43,0.03,-0.02,20100706,20110805,16,18,28,62,0,29,42,20,2.10,1.15,1.17,-0.43,13750.40
BMY,0.55,0.29,0.02,0.01,20100706,20110805,3,3,79,85,0,85,56,29,1.93,1.99,0.44,-0.30,3015.30
BSX,0.55,0.17,0.03,0.02,20100706,20110805,0,1,68,69,0,69,41,28,1.46,2.88,0.26,-0.14,1587.10
BTU,0.91,0.49,0.02,0.02,20100706,20110805,11,8,37,56,0,8,35,21,1.67,2.72,1.53,-0.52,14034.80
BWA,0.55,0.49,0.01,0.01,20101122,20110805,22,25,33,80,0,58,50,30,1.67,1.08,1.06,-0.54,14385.00
BYD,0.63,0.33,0,0.01,20101028,20110805,1,3,84,88,0,88,55,33,1.67,2.72,0.50,-0.34,5171.80
CAG,0.55,0.43,0.02,0,20100706,20110805,1,1,40,42,0,42,21,21,1.00,3.40,0.65,-0.43,1257.00
CAH,0.55,0.49,0,0.02,20101028,20110805,6,5,58,69,0,69,42,27,1.56,2.46,0.74,-0.52,6114.10
CAM,0.75,0.47,0.01,0.01,20100706,20110805,22,23,57,102,0,61,61,41,1.49,1.21,1.28,-0.49,14357.00
CAT,0.79,0.49,0.02,0.01,20100706,20110805,29,32,39,100,0,36,57,43,1.33,1.27,2.05,-0.50,22723.00
CBG,0.55,0.47,0.02,0.01,20101028,20110805,4,6,47,57,0,57,30,27,1.11,1.24,0.71,-0.48,3106.70
CBS,0.55,0.33,0.01,0,20100706,20110805,6,9,60,75,0,75,45,30,1.50,1.08,0.50,-0.33,5192.30
CCE,0.91,0.31,0,0.02,20100706,20110805,7,10,92,109,0,89,72,37,1.95,1.39,0.54,-0.33,8335.60
CCJ,0.79,0.41,0.02,0.01,20101028,20110805,6,9,40,55,0,32,39,16,2.44,1.30,1.09,-0.43,7969.10
CCL,0.55,0.45,0.04,0.01,20100706,20110805,9,16,44,69,0,69,42,27,1.56,0.99,0.69,-0.46,9174.00
CDE,1.03,0.37,0.01,0.02,20101028,20110805,17,9,37,63,0,13,34,29,1.17,1.74,1.41,-0.39,7499.30
CEG,0.71,0.17,0.02,0.01,20100706,20110805,25,24,35,84,0,39,49,35,1.40,0.46,0.53,-0.19,5736.60
CHK,0.67,0.49,0.02,0.01,20100706,20110805,3,1,67,71,0,70,39,32,1.22,7.71,0.74,-0.50,2972.90
CHS,0.91,0.21,0.03,0,20100706,20110805,6,11,50,67,0,57,43,24,1.79,0.55,0.39,-0.21,3443.70
CLF,1.15,0.39,0.02,0.02,20100706,20110805,36,15,34,85,0,4,37,48,0.77,2.22,2.60,-0.44,16697.80
CLX,0.63,0.49,0.03,0.01,20101028,20110805,1,6,47,54,0,52,33,21,1.57,1.65,0.92,-0.50,6262.00
CMA,0.55,0.45,0.02,0.01,20101028,20110805,2,4,55,61,0,61,49,12,4.08,2.78,0.68,-0.47,8636.80
CMC,0.55,0.33,0.01,0,20100706,20110805,2,1,68,71,0,71,38,33,1.15,4.91,0.50,-0.33,1382.40
CMI,0.75,0.49,0.04,0.02,20101028,20110805,18,13,7,38,0,12,20,18,1.11,1.48,2.46,-0.54,9970.80
CMS,0.71,0.11,0.02,0,20101028,20110805,10,17,32,59,0,40,36,23,1.57,0.24,0.23,-0.11,2630.60
CNP,0.55,0.23,0.02,0.02,20101028,20110805,0,1,57,58,0,58,34,24,1.42,3.22,0.35,-0.23,1189.50
CNQ,0.71,0.45,0.03,-0.01,20101028,20110805,10,11,29,50,0,35,33,17,1.94,1.13,0.88,-0.44,6925.50
CNX,0.55,0.49,0,0.01,20100706,20110805,20,23,50,93,0,79,56,37,1.51,1.20,1.06,-0.52,14145.60
COF,0.55,0.43,0.01,0.02,20100706,20110805,17,22,58,97,0,86,64,33,1.94,1.03,0.66,-0.46,12532.30
COH,0.55,0.31,0.02,0.02,20100706,20110805,21,25,24,70,0,44,42,28,1.50,0.62,0.78,-0.34,8000.20
COP,0.63,0.37,0.04,0.01,20100706,20110805,17,20,34,71,0,39,41,30,1.37,0.89,1.04,-0.39,9807.90
COV,0.95,0.37,0,-0.01,20100706,20110805,14,11,82,107,0,67,68,39,1.74,1.58,0.88,-0.37,9338.20
CPB,0.55,0.49,0.01,0.01,20101028,20110805,0,1,65,66,0,66,38,28,1.36,5.72,0.73,-0.32,3005.90
CPN,0.55,0.31,0.02,0.01,20101028,20110805,0,2,52,54,0,54,36,18,2.00,2.00,0.47,-0.24,2253.90
CRM,0.87,0.39,0.03,0.02,20100706,20110805,40,21,22,83,0,4,37,46,0.80,2.27,3.43,-0.47,30456.10
CSE,0.71,0.15,0.02,0.02,20101028,20110805,1,4,61,66,0,66,41,25,1.64,0.77,0.23,-0.17,1535.70
CSX,0.95,0.37,0.02,0,20100706,20110805,16,17,49,82,0,22,48,34,1.41,1.20,1.45,-0.38,12870.00
CTL,1.07,0.41,0.01,0.02,20101028,20110805,4,3,61,68,0,55,47,21,2.24,3.75,0.76,-0.43,5927.40
CVC,0.55,0.43,0.02,0,20101028,20110805,1,7,36,44,0,42,29,15,1.93,1.28,0.65,-0.42,6920.70
CVS,0.63,0.45,0.01,0.01,20100706,20110805,1,2,99,102,0,102,65,37,1.76,6.08,0.68,-0.46,7111.70
CVX,0.63,0.19,0.01,0.01,20100706,20110805,49,41,25,115,0,31,59,56,1.05,0.61,1.34,-0.21,14213.90
DAL,0.67,0.49,0.02,0,20100706,20110805,1,2,57,60,0,60,33,27,1.22,2.62,0.74,-0.49,2355.80
DAN,0.79,0.25,0.02,-0.01,20101028,20110805,8,12,32,52,0,34,35,17,2.06,0.61,0.53,-0.24,4772.50
DBC,0.55,0.45,0,0.01,20101028,20110805,1,2,72,75,0,75,47,28,1.68,3.53,0.68,-0.46,3342.20
DBS,1.11,0.49,0,0,20110214,20110805,8,8,18,34,0,2,24,10,2.40,2.47,2.49,-0.64,15567.80
DCT,0.55,0.13,0.02,0.01,20101028,20110805,1,0,59,60,0,60,36,24,1.50,0.00,0.19,-0.14,802.40
DDR,0.55,0.49,0.02,0.01,20101028,20110805,0,0,70,70,0,70,46,24,1.92,0.00,0.25,-0.32,1841.00
DFS,0.55,0.47,0.02,0,20100706,20110805,1,3,87,91,0,91,52,39,1.33,3.41,0.71,-0.47,6819.30
DHI,0.55,0.35,0.02,0.02,20100706,20110805,0,1,105,106,0,106,71,35,2.03,7.16,0.53,-0.22,4520.20
DHR,0.91,0.49,0,0.01,20101028,20110805,6,6,57,69,0,55,40,29,1.38,2.14,1.48,-0.50,5610.70
DIA,0.63,0.35,0.03,0.01,20100706,20110805,31,23,37,91,0,46,53,38,1.39,0.92,0.92,-0.37,8581.00
DIS,0.55,0.39,0.02,-0.01,20100706,20110805,5,3,58,66,0,66,32,34,0.94,1.75,0.59,-0.38,503.90
DLM,0.55,0.27,0.02,-0.03,20101028,20110805,0,0,5,5,0,5,5,0,Infinity,0.00,0.26,0.00,750.00
DNR,0.55,0.49,0,-0.05,20100706,20110805,4,1,84,89,0,89,57,32,1.78,10.82,0.74,-0.44,6278.90
DOW,0.91,0.47,0.03,0,20100706,20110805,5,4,53,62,0,43,34,28,1.21,2.14,0.76,-0.47,2857.00
DRE,0.55,0.39,0.02,0.01,20100706,20110805,0,0,95,95,0,95,63,32,1.97,0.00,0.40,-0.19,3941.40
DRI,0.55,0.29,0.02,-0.03,20100706,20110805,22,21,16,59,0,40,36,23,1.57,0.59,0.60,-0.26,6443.30
DTV,0.71,0.45,0.02,0,20100706,20110805,5,6,83,94,0,94,60,34,1.76,2.18,0.68,-0.45,7129.10
DUK,0.55,0.27,0.01,0.01,20100706,20110805,0,1,77,78,0,78,46,32,1.44,3.28,0.41,-0.13,1772.40
DVN,1.03,0.39,0.03,-0.05,20100706,20110805,15,6,30,51,0,7,29,22,1.32,2.62,1.72,-0.35,9593.50
DYN,0.55,0.17,0.02,0,20101028,20110805,0,2,31,33,0,33,23,10,2.30,1.04,0.26,-0.10,1440.50
ECA,0.55,0.37,0.02,0.01,20100706,20110805,1,6,54,61,0,60,40,21,1.90,1.36,0.57,-0.38,5717.30
EEM,0.79,0.11,0.03,0,20100706,20110805,29,13,34,76,0,13,39,37,1.05,0.64,0.61,-0.11,4597.90
EFA,0.55,0.43,0,0.01,20100706,20110805,6,8,71,85,0,83,48,37,1.30,1.62,0.65,-0.44,6616.30
EGO,0.55,0.23,0.04,0.01,20100706,20110805,11,18,52,81,0,78,55,26,2.12,0.57,0.35,-0.24,6359.90
EIX,0.55,0.45,0.02,-0.02,20101028,20110805,0,1,39,40,0,40,29,11,2.64,3.78,0.68,-0.31,2460.30
ELN,0.55,0.49,0.01,0.01,20101028,20110805,0,1,68,69,0,69,48,21,2.29,4.79,0.73,-0.18,3105.60
EMC,0.63,0.31,0.02,0.01,20100706,20110805,5,9,94,108,0,108,68,40,1.70,1.22,0.47,-0.32,5474.60
EMR,0.59,0.41,0.03,-0.02,20101028,20110805,4,11,30,45,0,38,31,14,2.21,0.91,0.76,-0.39,7356.70
EOG,0.55,0.47,0.02,0.02,20100706,20110805,27,29,13,69,0,45,39,30,1.30,0.95,2.36,-0.54,13805.10
ERO,0.91,0.27,0,-0.03,20110214,20110805,0,0,1,1,0,1,1,0,Infinity,0.00,0.24,0.00,236.00
ESV,0.63,0.39,0.01,0.01,20100706,20110805,32,26,39,97,0,69,55,42,1.31,0.82,0.86,-0.42,7043.00
EWA,0.55,0.29,0.03,0.02,20100706,20110805,3,6,67,76,0,76,44,32,1.38,1.15,0.44,-0.31,3371.00
EWC,0.91,0.33,0.03,0.01,20100706,20110805,3,3,59,65,0,55,37,28,1.32,1.71,0.50,-0.34,2371.00
EWG,0.55,0.49,0.02,0.02,20101028,20110805,1,0,47,48,0,48,33,15,2.20,0.00,0.61,-0.51,3771.00
EWH,0.55,0.21,0.02,0.01,20100706,20110805,0,2,82,84,0,84,52,32,1.63,1.69,0.32,-0.15,1929.90
EWJ,0.91,0.09,0.02,0.01,20100706,20110805,3,1,65,69,0,56,43,26,1.65,1.77,0.14,-0.10,695.70
EWM,0.63,0.05,0.02,0.01,20101028,20110805,6,19,24,49,0,24,30,19,1.58,0.10,0.11,-0.06,1204.90
EWS,0.55,0.27,0.02,0.01,20100706,20110805,0,0,46,46,0,46,30,16,1.88,0.00,0.15,-0.06,939.00
EWT,0.55,0.27,0.01,0.01,20100706,20110805,0,0,75,75,0,75,45,30,1.50,0.00,0.19,-0.15,1305.00
EWU,0.55,0.05,0,0.02,20101028,20110805,26,30,29,85,0,30,50,35,1.43,0.14,0.17,-0.07,1958.00
EWW,1.11,0.37,0.01,0.02,20101028,20110805,6,10,44,60,0,17,39,21,1.86,1.49,1.11,-0.40,10458.70
EWY,0.55,0.25,0.04,0.02,20100706,20110805,12,6,34,52,0,18,30,22,1.36,1.23,1.06,-0.27,3121.40
EWZ,0.83,0.43,0.02,0.02,20100706,20110805,18,15,34,67,0,26,37,30,1.23,1.26,1.22,-0.45,8387.00
EXC,1.11,0.47,0.01,0.01,20100706,20110805,1,3,84,88,0,78,47,41,1.15,3.23,0.78,-0.48,3668.80
FAS,0.55,0.43,0,0.01,20101028,20110805,9,15,40,64,0,59,44,20,2.20,1.12,0.70,-0.44,10664.00
FAZ,1.07,0.41,0,0,20101028,20110805,9,7,25,41,0,7,29,12,2.42,1.93,1.48,-0.42,9212.20
FCS,0.55,0.49,0,0.01,20101028,20110805,2,3,66,71,0,71,42,29,1.45,3.33,0.76,-0.50,5250.40
FDO,0.67,0.29,0.01,0.02,20101028,20110805,11,22,33,66,0,55,42,24,1.75,0.61,0.63,-0.32,8042.50
FDX,0.55,0.33,0.02,0.01,20100706,20110805,34,32,23,89,0,49,46,43,1.07,0.71,1.29,-0.35,10374.00
FHN,0.55,0.39,0.02,0.02,20100706,20110805,1,1,63,65,0,65,41,24,1.71,5.13,0.59,-0.41,3085.00
FIS,0.95,0.27,0.02,0.01,20100706,20110805,9,6,69,84,0,66,52,32,1.63,1.37,0.48,-0.28,3827.60
FLR,0.67,0.43,0,0.01,20101028,20110805,16,23,16,55,0,33,34,21,1.62,0.90,1.05,-0.45,13057.60
FRX,0.55,0.49,0.02,0.02,20101028,20110805,0,1,47,48,0,48,31,17,1.82,5.97,0.74,-0.33,3354.50
FTO,1.11,0.47,0.02,0.02,20101028,20110805,9,11,30,50,0,24,34,16,2.13,1.51,1.09,-0.50,10632.40
FTR,0.79,0.07,0.02,0.02,20100706,20110805,8,21,63,92,0,81,57,35,1.63,0.18,0.17,-0.10,2059.90
FXB,1.11,0.23,0.03,0,20110214,20110805,4,2,13,19,0,0,14,5,2.80,2.70,1.05,-0.26,4915.50
FXI,1.11,0.47,0,-0.02,20100706,20110805,2,2,46,50,0,29,30,20,1.50,3.21,0.75,-0.45,3628.40
GCI,0.91,0.17,0.02,-0.02,20101028,20110805,2,6,24,32,0,19,22,10,2.20,0.46,0.34,-0.15,2130.00
GDX,0.71,0.49,0,0.02,20100706,20110805,19,17,55,91,0,58,55,36,1.53,1.39,1.06,-0.51,11492.60
GFA,0.55,0.49,0.02,0.01,20101028,20110805,0,2,63,65,0,65,42,23,1.83,3.17,0.74,-0.26,4673.50
GFI,0.67,0.11,0.02,0.01,20100706,20110805,22,33,46,101,0,57,61,40,1.52,0.25,0.32,-0.12,4854.00
GGB,0.83,0.17,0.02,0.01,20100706,20110805,12,11,48,71,0,40,47,24,1.96,0.61,0.34,-0.20,3867.60
GGP,0.71,0.49,0,0.01,20101028,20110805,1,2,86,89,0,89,59,30,1.97,4.95,0.76,-0.50,6214.20
GIS,0.55,0.27,0.01,0.01,20100706,20110805,5,5,73,83,0,83,47,36,1.31,1.41,0.41,-0.28,2730.80
GLD,0.99,0.39,0.04,0.01,20100706,20110805,20,8,44,72,0,3,40,32,1.25,2.93,2.19,-0.41,13810.20
GLW,0.55,0.23,0.02,0.01,20100706,20110805,8,11,69,88,0,88,49,39,1.26,0.75,0.35,-0.24,4195.00
GME,0.91,0.45,0.02,0.02,20100706,20110805,2,1,74,77,0,73,41,36,1.14,7.85,0.68,-0.47,3206.30
GMR,0.55,0.17,0,0.01,20100706,20110805,2,3,122,127,0,127,76,51,1.49,1.82,0.26,-0.18,2640.50
GNW,0.55,0.47,0.02,0.01,20100706,20110805,1,1,56,58,0,58,32,26,1.23,5.54,0.71,-0.48,2492.90
GPS,0.55,0.15,0.02,0.01,20100706,20110805,10,19,43,72,0,63,45,27,1.67,0.35,0.27,-0.16,3805.60
GSK,0.55,0.49,0,0.01,20101028,20110805,0,0,50,50,0,50,31,19,1.63,0.00,0.41,-0.29,1564.90
GSS,0.55,0.27,0.01,0.01,20100706,20110805,0,0,109,109,0,109,73,36,2.03,0.00,0.22,-0.12,2744.30
HAL,0.91,0.47,0.04,0,20100706,20110805,13,8,33,54,0,25,31,23,1.35,1.71,1.12,-0.47,5617.80
HCP,1.11,0.49,0.02,0.01,20100706,20110805,2,1,67,70,0,55,46,24,1.92,8.75,0.92,-0.50,4365.10
HES,0.67,0.35,0.01,0.02,20101028,20110805,15,18,17,50,0,27,29,21,1.38,0.80,1.52,-0.38,8085.40
HIG,0.71,0.49,0,0.01,20100706,20110805,6,4,75,85,0,84,55,30,1.83,3.46,0.74,-0.50,7452.40
HMA,0.63,0.21,0.02,0.01,20100706,20110805,1,3,58,62,0,62,35,27,1.30,1.17,0.32,-0.22,1803.60
HMY,0.83,0.03,0.02,0.01,20100706,20110805,45,23,20,88,0,12,40,48,0.83,0.21,0.38,-0.05,2566.50
HOG,0.55,0.47,0,-0.02,20100706,20110805,16,11,71,98,0,98,58,40,1.45,1.47,0.72,-0.45,6053.10
HON,0.83,0.43,0.02,0,20100706,20110805,10,7,64,81,0,61,50,31,1.61,1.92,0.81,-0.43,6260.10
HOT,0.55,0.37,0,0.02,20101028,20110805,16,19,26,61,0,39,41,20,2.05,0.86,1.00,-0.40,9705.50
HOV,1.07,0.11,0,0.01,20100706,20110805,12,13,119,144,0,114,87,57,1.53,0.47,0.31,-0.12,2756.70
HPQ,0.79,0.45,0.02,0.02,20100706,20110805,6,7,63,76,0,64,49,27,1.81,2.54,4.01,-0.47,11650.00
HRB,0.67,0.19,0.02,0.01,20101028,20110805,4,8,22,34,0,30,21,13,1.62,0.45,0.34,-0.20,2194.00
HST,0.63,0.33,0.02,0.02,20100706,20110805,1,2,70,73,0,73,45,28,1.61,3.67,0.50,-0.35,4293.40
HTZ,0.55,0.21,0.02,0.01,20100706,20110805,9,18,69,96,0,96,63,33,1.91,0.56,0.32,-0.22,6205.80
HUN,0.55,0.49,0.02,0.01,20101028,20110805,1,2,60,63,0,63,42,21,2.00,3.47,0.74,-0.50,4350.80
IAG,0.67,0.35,0.02,0.01,20100706,20110805,4,3,72,79,0,79,42,37,1.14,2.23,0.53,-0.36,1649.00
IAU,0.63,0.15,0.02,0.02,20101028,20110805,1,8,66,75,0,75,48,27,1.78,0.47,0.23,-0.98,1565.80
IBM,0.63,0.49,0.04,0.02,20100706,20110805,19,28,33,80,0,47,50,30,1.67,1.18,1.69,-0.54,21571.50
IBN,0.83,0.31,0.02,0.01,20100706,20110805,11,9,39,59,0,13,36,23,1.57,1.40,1.27,-0.35,7898.00
ICO,0.55,0.35,0,0.01,20101028,20110805,2,2,38,42,0,42,26,16,1.63,2.18,0.53,-0.35,2578.60
IGT,0.55,0.45,0.02,0.01,20100706,20110805,1,2,77,80,0,80,52,28,1.86,2.83,0.69,-0.46,1766.50
ING,0.79,0.17,0.01,0.02,20101028,20110805,1,10,51,62,0,42,37,25,1.48,0.49,0.37,-0.19,3044.10
IPG,0.55,0.25,0.02,0.01,20100706,20110805,1,0,88,89,0,89,56,33,1.70,0.00,0.33,-0.26,3361.50
ITW,0.83,0.49,0.04,0.02,20100706,20110805,3,6,48,57,0,49,37,20,1.85,1.85,0.85,-0.51,6415.50
IVN,0.91,0.43,0.02,0.01,20101028,20110805,9,7,54,70,0,44,42,28,1.50,1.67,0.80,-0.47,5272.20
IVV,0.55,0.49,0.02,-0.01,20100706,20110805,10,11,58,79,0,63,51,28,1.82,1.79,1.01,-0.50,11992.10
IVZ,0.55,0.49,0.02,0,20101028,20110805,1,1,48,50,0,50,28,22,1.27,5.42,0.74,-0.49,2823.70
IWD,0.87,0.37,0.02,-0.04,20100706,20110805,5,1,51,57,0,35,36,21,1.71,7.84,0.58,-0.35,4342.70
IWF,0.59,0.21,0.02,0.02,20101028,20110805,17,18,27,62,0,47,33,29,1.14,0.42,0.49,-0.24,2762.80
IWM,0.71,0.27,0.04,-0.01,20100706,20110805,35,31,31,97,0,23,60,37,1.62,1.08,1.90,-0.26,23652.00
IWN,1.03,0.31,0,0.01,20100706,20110805,42,17,65,124,0,13,67,57,1.18,1.81,1.26,-0.33,15842.30
IWO,0.71,0.41,0.04,0,20100706,20110805,22,15,30,67,0,27,39,28,1.39,1.40,1.44,-0.43,10955.40
IYR,0.75,0.41,0.02,0.01,20100706,20110805,13,12,66,91,0,70,60,31,1.94,1.53,0.75,-0.42,9887.10
JBL,0.55,0.41,0.02,0,20100706,20110805,2,3,77,82,0,82,51,31,1.65,3.53,0.62,-0.41,5953.90
JCI,1.03,0.49,0,0.02,20100706,20110805,10,10,85,105,0,80,63,42,1.50,1.80,0.77,-0.51,8042.70
JCP,0.59,0.39,0.01,0.01,20100706,20110805,11,9,59,79,0,73,53,26,2.04,1.41,0.60,-0.40,6039.10
JNJ,0.67,0.17,0.02,0.02,20100706,20110805,30,25,36,91,0,45,50,41,1.22,0.43,0.50,-0.19,4198.00
JNS,0.55,0.37,0,0.01,20101028,20110805,0,1,69,70,0,70,35,35,1.00,4.86,0.56,-0.30,1854.10
JNY,0.55,0.49,0,0.02,20101028,20110805,0,0,65,65,0,65,43,22,1.95,0.00,0.38,-0.35,3032.40
JPM,0.67,0.41,0.03,0.02,20100706,20110805,13,13,77,103,0,90,66,37,1.78,1.30,0.69,-0.43,7965.50
JWN,0.55,0.45,0.02,0,20101028,20110805,7,14,31,52,0,51,34,18,1.89,1.08,0.72,-0.45,10231.60
KBE,0.91,0.23,0.03,0.01,20101028,20110805,2,4,31,37,0,27,25,12,2.08,0.81,0.42,-0.24,1932.00
KBH,0.55,0.45,0.02,0.01,20100706,20110805,0,3,80,83,0,83,50,33,1.52,2.58,0.68,-0.32,3679.30
KEY,0.55,0.23,0.01,0.02,20100706,20110805,2,3,119,124,0,124,73,51,1.43,2.26,0.35,-0.25,3440.90
KFT,0.91,0.11,0,0.01,20100706,20110805,33,27,51,111,0,28,66,45,1.47,0.38,0.40,-0.12,5738.40
KGC,0.87,0.27,0.02,0.01,20100706,20110805,8,7,62,77,0,64,45,32,1.41,1.14,0.48,-0.28,3661.00
KIM,0.63,0.29,0.01,-0.01,20100706,20110805,3,2,88,93,0,93,65,28,2.32,4.77,0.44,-0.28,7135.50
KMB,0.55,0.37,0.01,0,20101028,20110805,5,5,42,52,0,52,33,19,1.74,1.52,0.56,-0.37,4455.10
KMX,1.03,0.45,0.02,-0.01,20100706,20110805,6,7,47,60,0,36,33,27,1.22,1.40,0.90,-0.44,4642.70
KRE,0.55,0.23,0,0.01,20101028,20110805,5,6,65,76,0,76,43,33,1.30,1.09,0.36,-0.24,2998.90
KSS,0.95,0.49,0,0.02,20101028,20110805,7,10,56,73,0,49,46,27,1.70,1.59,1.02,-0.51,8667.00
LCC,0.55,0.31,0,0.01,20100706,20110805,10,5,70,85,0,85,45,40,1.13,1.37,0.47,-0.32,1436.00
LDK,1.07,0.33,0,0.01,20101028,20110805,4,6,66,76,0,54,45,31,1.45,1.39,0.81,-0.34,4817.50
LEN,0.67,0.37,0.02,0.01,20100706,20110805,4,5,72,81,0,81,52,29,1.79,1.73,0.56,-0.38,4356.70
LIZ,0.55,0.21,0,0.02,20101103,20110805,3,2,75,80,0,80,48,32,1.50,2.24,0.32,-0.23,2173.60
LLY,0.67,0.35,0.02,0.01,20100706,20110805,2,4,82,88,0,88,48,40,1.20,2.12,0.53,-0.36,4577.90
LMT,0.75,0.37,0.03,0.01,20101028,20110805,8,14,32,54,0,30,37,17,2.18,1.00,1.12,-0.39,9570.90
LNC,0.91,0.43,0.02,0.01,20100706,20110805,7,8,67,82,0,61,55,27,2.04,1.86,0.91,-0.44,7731.30
LOW,0.63,0.29,0,0.01,20100706,20110805,7,7,60,74,0,74,43,31,1.39,1.19,0.44,-0.30,3890.80
LPX,1.11,0.23,0.02,0.02,20101028,20110805,1,5,66,72,0,65,46,26,1.77,1.24,0.39,-0.25,3494.60
LSI,0.55,0.19,0.02,0.01,20100706,20110805,0,2,75,77,0,77,45,32,1.41,1.53,0.29,-0.10,1765.30
LTD,0.55,0.35,0.02,0.01,20100706,20110805,9,10,59,78,0,77,48,30,1.60,1.13,0.53,-0.37,5169.30
LUV,0.55,0.39,0.01,0.02,20100706,20110805,0,0,122,122,0,122,67,55,1.22,0.00,0.46,-0.30,2157.40
LYV,0.55,0.39,0.02,0.01,20100706,20110805,0,1,105,106,0,106,62,44,1.41,10.06,0.59,-0.23,5901.70
MAR,0.63,0.27,0.02,0,20100706,20110805,13,17,49,79,0,61,47,32,1.47,0.62,0.60,-0.28,5513.90
MAS,0.55,0.33,0.04,0.01,20100706,20110805,2,3,43,48,0,48,31,17,1.82,1.61,0.50,-0.34,2888.00
MAT,0.55,0.49,0.02,0.01,20100706,20110805,0,0,72,72,0,72,46,26,1.77,0.00,0.55,-0.33,2482.00
MBI,0.55,0.39,0,0.01,20100706,20110805,2,2,77,81,0,81,51,30,1.70,4.45,0.59,-0.40,5534.20
MBT,1.03,0.35,0.03,0,20101028,20110805,0,2,34,36,0,29,22,14,1.57,2.17,0.60,-0.23,3091.00
MCD,1.11,0.49,0.02,-0.04,20100706,20110805,8,2,46,56,0,25,35,21,1.67,5.11,0.82,-0.45,4726.00
MCO,0.83,0.15,0.04,-0.02,20100706,20110805,15,11,27,53,0,14,34,19,1.79,0.53,0.67,-0.13,3608.00
MDT,0.67,0.37,0.01,0.01,20100706,20110805,2,5,75,82,0,81,47,35,1.34,1.71,0.56,-0.38,4351.30
MDY,1.11,0.41,0.02,-0.01,20100706,20110805,38,11,39,88,0,2,46,42,1.10,3.84,2.91,-0.44,26267.30
MEE,1.03,0.43,0.03,0.01,20101028,20110805,16,11,18,45,0,7,26,19,1.37,1.53,1.67,-0.45,9087.50
MET,1.11,0.43,0.02,-0.05,20100706,20110805,7,3,61,71,0,16,48,23,2.09,3.62,0.82,-0.38,6097.40
MFA,0.55,0.27,0,-0.01,20100706,20110805,0,0,92,92,0,92,60,32,1.88,0.00,0.14,-0.09,1637.20
MFC,0.63,0.33,0,0,20101028,20110805,3,6,61,70,0,70,45,25,1.80,1.17,0.50,-0.33,4272.40
MFE,0.55,0.19,0.02,0.02,20101028,20110805,0,0,5,5,0,5,5,0,Infinity,0.00,0.25,0.00,548.70
MGM,0.55,0.25,0.03,-0.02,20100706,20110805,5,8,34,47,0,47,30,17,1.76,0.74,0.55,-0.23,3840.50
MHP,0.59,0.11,0.03,0.01,20100706,20110805,28,34,17,79,0,45,44,35,1.26,0.24,0.50,-0.12,4263.40
MHS,0.55,0.41,0.01,0.01,20101028,20110805,6,16,47,69,0,64,46,23,2.00,1.00,0.83,-0.42,11464.30
MMC,1.03,0.29,0.03,-0.02,20100706,20110805,5,8,46,59,0,42,42,17,2.47,0.97,0.46,-0.27,4956.90
MMM,0.75,0.49,0.02,0.01,20100706,20110805,19,15,29,63,0,30,34,29,1.17,1.24,1.13,-0.55,7296.20
MMR,0.55,0.25,0.02,-0.05,20101028,20110805,12,12,19,43,0,37,28,15,1.87,0.61,0.45,-0.20,4540.20
MON,0.55,0.49,0.01,0.01,20100706,20110805,12,13,27,52,0,36,30,22,1.36,1.16,1.14,-0.51,7526.10
MOS,0.87,0.49,0.02,0.01,20101028,20110805,22,15,26,63,0,16,37,26,1.42,1.70,2.32,-0.50,13752.90
MRK,0.55,0.49,0.02,0,20100706,20110805,1,2,80,83,0,83,50,33,1.52,4.16,0.74,-0.49,3731.40
MTG,0.55,0.19,0.03,0.01,20100706,20110805,3,14,49,66,0,64,44,22,2.00,0.49,0.29,-0.20,4982.90
MTL,0.79,0.35,0.02,0.01,20100706,20110805,7,9,43,59,0,37,39,20,1.95,1.11,0.76,-0.36,5769.00
MTU,0.55,0.27,0.01,0.01,20101028,20110805,0,0,52,52,0,52,30,22,1.36,0.00,0.09,-0.06,378.50
MTW,0.83,0.37,0,0,20101028,20110805,3,5,54,62,0,57,43,19,2.26,1.76,0.60,-0.38,5334.10
MWW,0.55,0.39,0.03,0.01,20100706,20110805,1,1,61,63,0,63,43,20,2.15,5.58,0.59,-0.40,3053.00
MYL,0.55,0.13,0.01,0.01,20100706,20110805,23,30,50,103,0,86,61,42,1.45,0.31,0.44,-0.14,4842.20
NBR,0.95,0.49,0,0.02,20100706,20110805,11,10,98,119,0,99,73,46,1.59,2.14,0.82,-0.51,11049.60
NEM,0.55,0.33,0.02,0.01,20100706,20110805,32,26,22,80,0,63,38,42,0.90,2.83,58.50,-0.36,61674.90
NKE,0.95,0.49,0,-0.05,20101028,20110805,10,9,28,47,0,13,32,15,2.13,1.75,1.28,-0.47,10801.80
NLY,0.55,0.27,0,-0.02,20100706,20110805,0,0,87,87,0,87,62,25,2.48,0.00,0.27,-0.17,3205.90
NOK,0.55,0.27,0.02,0.01,20100706,20110805,0,0,76,76,0,76,40,36,1.11,0.00,0.25,-0.14,1154.00
NOV,0.55,0.43,0,-0.03,20100706,20110805,20,17,38,75,0,58,43,32,1.34,1.15,1.38,-0.41,9582.80
NRG,0.55,0.49,0.01,-0.01,20101028,20110805,0,0,54,54,0,54,35,19,1.84,0.00,0.53,-0.32,2896.50
NSC,0.71,0.37,0.01,0,20101028,20110805,20,16,18,54,0,24,27,27,1.00,0.83,1.00,-0.37,4737.50
NSM,0.55,0.17,0.02,0.01,20100706,20110805,5,8,46,59,0,59,38,21,1.81,0.52,0.26,-0.18,2101.50
NUE,0.55,0.41,0.02,0.02,20101028,20110805,8,10,49,67,0,66,40,27,1.48,1.16,0.62,-0.44,5856.40
NVS,0.91,0.39,0.01,0.02,20101028,20110805,8,7,52,67,0,32,38,29,1.31,1.44,0.74,-0.42,4257.90
NWL,0.55,0.29,0.02,0.02,20100706,20110805,1,1,88,90,0,90,57,33,1.73,6.75,0.44,-0.31,3616.80
NXY,0.99,0.31,0.03,0.01,20101028,20110805,14,12,49,75,0,33,44,31,1.42,1.09,0.87,-0.32,6947.90
NYB,0.67,0.11,0.02,0.02,20101028,20110805,13,20,62,95,0,84,64,31,2.06,0.31,0.19,-0.13,3545.60
NYT,0.55,0.21,0.02,0.02,20101028,20110805,2,3,66,71,0,71,43,28,1.54,1.74,0.32,-0.23,2805.60
NYX,0.75,0.45,0.01,-0.02,20101028,20110805,1,7,60,68,0,61,52,16,3.25,1.82,0.91,-0.43,10679.10
OCR,0.59,0.15,0,0.01,20101103,20110805,19,24,30,73,0,46,44,29,1.52,0.31,0.36,-0.16,3837.60
ODP,0.55,0.27,0,0.02,20100706,20110805,0,0,137,137,0,137,85,52,1.63,0.00,0.32,-0.22,3646.00
OIH,0.75,0.43,0.02,-0.02,20100706,20110805,42,24,17,83,0,19,36,47,0.77,1.43,3.08,-0.44,16540.80
OMC,0.55,0.41,0.02,0.01,20101028,20110805,5,9,33,47,0,47,30,17,1.76,1.10,0.63,-0.42,5991.40
OXY,0.59,0.45,0,0,20100706,20110805,36,43,26,105,0,65,60,45,1.33,0.95,1.76,-0.47,23029.60
PBI,0.55,0.19,0.02,0.01,20101028,20110805,2,6,56,64,0,64,46,18,2.56,0.95,0.29,-0.20,4297.00
PBR,1.03,0.49,0,-0.02,20100706,20110805,10,7,58,75,0,33,42,33,1.27,2.21,1.01,-0.47,6904.70
PCG,0.55,0.23,0.01,0.01,20101028,20110805,10,13,35,58,0,56,42,16,2.63,0.64,0.37,-0.24,5376.20
PCS,0.55,0.27,0.03,0.01,20100706,20110805,1,3,52,56,0,56,35,21,1.67,1.54,0.41,-0.28,2817.50
PCX,0.63,0.49,0.01,-0.03,20100706,20110805,10,12,76,98,0,93,65,33,1.97,1.72,0.91,-0.46,13076.10
PDE,0.87,0.47,0.02,-0.03,20101028,20110805,2,2,30,34,0,31,23,11,2.09,2.89,0.71,-0.45,3874.00
PEG,0.71,0.35,0.02,0.02,20100706,20110805,6,6,80,92,0,91,56,36,1.56,1.81,0.53,-0.38,5307.60
PEP,1.19,0.35,0.02,0.01,20100706,20110805,12,10,64,86,0,18,60,26,2.31,1.60,1.48,-0.36,9943.40
PFE,0.55,0.13,0.01,0.01,20100706,20110805,19,25,81,125,0,121,73,52,1.40,0.30,0.21,-0.14,3248.40
PFG,0.67,0.39,0,0.01,20101028,20110806,9,7,56,72,0,70,43,29,1.48,1.55,0.59,-0.41,5340.50
PGR,0.55,0.39,0.02,0.01,20100706,20110806,0,0,94,94,0,94,58,36,1.61,0.00,0.41,-0.24,4571.50
PHM,0.55,0.49,0,0.01,20100706,20110806,0,0,108,108,0,108,76,32,2.38,0.00,0.41,-0.25,5831.00
PIR,0.55,0.23,0.01,0.01,20100706,20110806,7,6,86,99,0,99,63,36,1.75,1.36,0.35,-0.24,4086.90
PLD,1.11,0.41,0,0,20100706,20110806,5,3,103,111,0,95,66,45,1.47,3.99,0.90,-0.41,6509.70
PNC,1.11,0.47,0.01,0.01,20100706,20110806,15,8,42,65,0,15,39,26,1.50,2.39,2.02,-0.49,10052.10
POT,1.11,0.47,0,0,20101028,20110806,8,5,18,31,0,3,21,10,2.10,2.58,1.65,-0.47,8589.90
PPL,0.87,0.11,0.01,0,20100706,20110806,28,16,35,79,0,22,41,38,1.08,0.38,0.47,-0.11,2424.00
PRU,0.87,0.45,0,0.02,20101028,20110806,14,13,52,79,0,37,51,28,1.82,1.72,1.19,-0.48,13541.20
PSE,1.03,0.39,0,0.01,20101028,20110806,11,11,61,83,0,36,55,28,1.96,1.67,1.06,-0.45,12637.60
PWR,0.55,0.41,0.02,0.02,20101028,20110806,2,1,47,50,0,50,35,15,2.33,5.92,0.62,-0.42,3444.20
PXP,0.55,0.47,0.02,0.01,20101028,20110806,8,10,39,57,0,55,33,24,1.38,1.21,0.72,-0.48,5534.40
QID,0.87,0.49,0.02,0.01,20100706,20110806,11,10,16,37,0,11,24,13,1.85,1.47,1.59,-0.51,8689.50
QLD,0.91,0.35,0.04,-0.05,20101028,20110806,31,11,17,59,0,9,27,32,0.84,1.96,2.67,-0.32,12013.70
RAD,0.55,0.05,0.01,0.01,20100706,20110806,1,3,52,56,0,56,33,23,1.43,0.27,0.08,-0.06,318.50
RAI,0.55,0.49,0.02,-0.01,20101028,20110806,0,1,32,33,0,33,25,8,3.13,4.56,0.74,-0.34,2968.90
RCL,0.55,0.45,0,-0.01,20100706,20110806,20,19,61,100,0,89,58,42,1.38,1.18,0.74,-0.45,10939.10
RDN,0.55,0.29,0.01,0.01,20100706,20110806,4,6,116,126,0,126,82,44,1.86,1.75,0.44,-0.30,6215.40
RHT,0.63,0.35,0.01,0.01,20100706,20110806,20,19,47,86,0,71,54,32,1.69,0.92,0.67,-0.37,8569.40
RIG,0.67,0.41,0.02,0.02,20100706,20110806,42,32,28,102,0,37,54,48,1.13,1.06,1.91,-0.48,14657.10
RIO,0.87,0.47,0,0.02,20101028,20110806,8,6,32,46,0,4,28,18,1.56,2.78,1.73,-0.50,11521.00
RRC,0.55,0.41,0.02,0.01,20100706,20110806,12,14,45,71,0,65,42,29,1.45,0.95,0.88,-0.42,5901.00
RSG,0.55,0.37,0,0.01,20101028,20110806,2,2,51,55,0,55,34,21,1.62,3.11,0.56,-0.38,3195.80
RSH,0.55,0.41,0.02,0,20101028,20110806,1,1,59,61,0,61,39,22,1.77,4.78,0.62,-0.41,2746.90
RTN,0.63,0.49,0.01,0,20101028,20110806,3,5,46,54,0,54,34,20,1.70,1.98,0.74,-0.49,6644.30
SAI,0.55,0.49,0.02,0.01,20101028,20110806,0,0,65,65,0,65,39,26,1.50,0.00,0.32,-0.19,1380.10
SCO,0.87,0.49,0,-0.05,20101028,20110806,5,4,14,23,0,5,18,5,3.60,3.37,2.01,-0.45,11221.00
SDS,0.67,0.27,0.02,0.02,20100706,20110806,8,7,59,74,0,63,45,29,1.55,1.11,0.56,-0.29,3748.60
SFD,0.55,0.49,0.02,0.01,20101028,20110806,0,0,52,52,0,52,37,15,2.47,0.00,0.61,-0.47,3337.00
SID,0.55,0.43,0.01,0.01,20100706,20110806,0,1,93,94,0,94,56,38,1.47,7.21,0.65,-0.24,4273.30
SKF,0.59,0.45,0.01,0.02,20101028,20110806,8,14,18,40,0,25,30,10,3.00,1.02,1.51,-0.48,9766.60
SKS,0.55,0.27,0.02,0.01,20100706,20110806,0,1,81,82,0,82,51,31,1.65,6.54,0.41,-0.22,3408.10
SLB,1.07,0.39,0.04,0.01,20100706,20110806,35,10,38,83,0,8,40,43,0.93,2.90,2.31,-0.42,13638.40
SLE,0.55,0.39,0,0.01,20100706,20110806,2,1,69,72,0,72,41,31,1.32,3.86,0.59,-0.43,788.20
SLM,0.55,0.37,0.02,0.01,20101028,20110806,0,2,66,68,0,68,48,20,2.40,3.15,0.56,-0.24,4580.50
SLV,1.11,0.49,0.02,0.02,20100706,20110806,6,2,67,75,0,42,44,31,1.42,5.40,0.85,-0.51,3809.00
SLW,0.55,0.39,0.04,-0.02,20100706,20110806,11,13,27,51,0,28,35,16,2.19,1.13,1.01,-0.37,9936.30
SMH,0.55,0.39,0.02,0.01,20100706,20110806,7,5,75,87,0,87,45,42,1.07,1.88,0.59,-0.40,2762.10
SNV,0.55,0.27,0.02,0.02,20100706,20110806,0,0,66,66,0,66,36,30,1.20,0.00,0.13,-0.09,855.50
SNY,0.71,0.35,0.02,0.01,20101028,20110806,0,3,45,48,0,42,32,16,2.00,2.04,0.53,-0.23,4132.90
SOL,0.67,0.33,0,0.01,20101028,20110806,5,3,65,73,0,71,48,25,1.92,2.98,0.55,-0.34,5261.80
SPF,0.55,0.27,0.02,0.01,20100706,20110806,0,0,86,86,0,86,53,33,1.61,0.00,0.31,-0.16,1875.10
SPY,0.59,0.47,0.01,-0.05,20100706,20110806,16,15,40,71,0,47,42,29,1.45,1.33,1.08,-0.42,11683.10
SSO,0.55,0.39,0,-0.02,20101028,20110806,14,16,48,78,0,64,49,29,1.69,1.08,0.80,-0.37,9687.60
STD,0.55,0.27,0.01,0.01,20100706,20110806,1,2,63,66,0,66,40,26,1.54,2.32,0.41,-0.28,3033.70
STI,0.55,0.33,0.04,0.02,20100706,20110806,9,15,50,74,0,73,41,33,1.24,0.77,0.57,-0.35,5034.50
STJ,0.91,0.49,0.01,-0.02,20101028,20110806,7,8,45,60,0,45,41,19,2.16,1.46,0.78,-0.47,6995.90
STP,0.71,0.21,0.02,0,20100706,20110806,6,6,53,65,0,61,45,20,2.25,0.98,0.36,-0.21,3401.00
STT,0.71,0.33,0.02,0.01,20100706,20110806,14,17,36,67,0,32,39,28,1.39,0.84,0.76,-0.35,7541.30
STX,0.55,0.49,0,0.01,20100706,20110806,2,2,108,112,0,112,65,47,1.38,5.76,0.74,-0.57,5259.30
SUN,0.55,0.11,0.02,0,20100706,20110806,41,44,10,95,0,51,50,45,1.11,0.23,0.47,-0.12,4902.60
SVM,0.55,0.25,0.01,0.02,20101028,20110806,10,12,48,70,0,62,45,25,1.80,0.70,0.40,-0.27,3971.40
SVU,0.55,0.37,0,0.02,20100706,20110806,2,1,142,145,0,145,88,57,1.54,11.46,0.56,-0.39,5010.70
SWC,0.55,0.33,0.02,0.02,20101028,20110806,9,12,35,56,0,51,35,21,1.67,0.80,0.68,-0.35,5005.90
SWK,0.59,0.35,0.03,0.01,20100706,20110806,31,35,30,96,0,52,60,36,1.67,0.73,0.96,-0.39,13679.70
SWN,0.55,0.41,0,0,20100706,20110806,26,23,72,121,0,110,70,51,1.37,1.02,0.80,-0.42,9537.20
SWY,0.99,0.29,0.03,0,20100706,20110806,2,5,75,82,0,69,58,24,2.42,1.65,0.48,-0.29,6190.30
SYY,0.55,0.35,0.01,0.02,20101028,20110806,2,2,71,75,0,75,47,28,1.68,3.54,0.53,-0.37,3561.80
TCB,0.55,0.47,0.02,-0.01,20101028,20110806,1,4,58,63,0,63,39,24,1.63,1.71,0.71,-0.46,4694.50
TCK,0.91,0.37,0.02,0.01,20100706,20110806,23,13,24,60,0,9,32,28,1.14,1.60,1.73,-0.39,11130.20
TEF,0.67,0.43,0,0.01,20101028,20110806,0,2,52,54,0,54,34,20,1.70,2.59,0.65,-0.22,3485.10
TEL,0.55,0.37,0,0.01,20101028,20110806,8,9,49,66,0,66,45,21,2.14,1.38,0.56,-0.39,7306.00
TER,0.95,0.15,0.03,0,20100706,20110806,17,13,48,78,0,27,43,35,1.23,0.55,0.48,-0.15,3405.70
TEX,0.71,0.47,0.01,-0.05,20101028,20110806,10,10,33,53,0,41,33,20,1.65,1.16,0.88,-0.43,5803.30
TGT,0.55,0.45,0.02,0.01,20100706,20110806,13,14,69,96,0,96,57,39,1.46,1.40,0.69,-0.46,9006.60
THC,0.55,0.27,0.01,0.01,20101028,20110806,0,0,75,75,0,75,44,31,1.42,0.00,0.20,-0.08,1114.30
TIE,0.55,0.33,0.02,0,20100706,20110806,9,11,62,82,0,77,47,35,1.34,0.93,0.53,-0.33,4492.50
TJX,0.63,0.33,0.02,0.01,20100706,20110806,14,13,46,73,0,60,45,28,1.61,0.89,0.63,-0.34,5222.00
TLB,0.55,0.49,0.02,-0.01,20100706,20110806,0,1,58,59,0,59,33,26,1.27,6.92,0.74,-0.43,4448.90
TLM,0.55,0.49,0.02,-0.05,20100706,20110806,1,1,34,36,0,36,25,11,2.27,6.28,0.74,-0.44,4765.90
TLT,0.91,0.49,0.01,0.01,20100706,20110806,22,14,72,108,0,49,66,42,1.57,1.93,1.36,-0.51,13494.00
TMO,1.11,0.49,0.02,0.02,20101028,20110806,6,7,49,62,0,28,40,22,1.82,1.97,1.21,-0.52,7989.00
TOL,0.55,0.49,0.01,-0.03,20100706,20110806,2,1,72,75,0,75,46,29,1.59,8.08,0.74,-0.46,4684.80
TOT,0.55,0.47,0,-0.04,20100706,20110806,7,5,58,70,0,70,39,31,1.26,2.25,0.71,-0.43,5139.70
TRV,0.55,0.49,0.01,0.01,20100706,20110806,4,2,74,80,0,80,42,38,1.11,5.20,0.74,-0.50,3070.10
TSL,0.55,0.37,0.01,0,20101028,20110806,7,15,28,50,0,45,36,14,2.57,0.83,0.71,-0.38,9038.90
TSM,0.55,0.23,0.02,-0.01,20100706,20110806,0,2,53,55,0,55,44,11,4.00,2.06,0.35,-0.05,3647.50
TSN,0.55,0.47,0.02,0.02,20100706,20110806,1,1,102,104,0,104,59,45,1.31,7.80,0.71,-0.49,3137.50
TSO,0.75,0.39,0.01,0,20100706,20110806,8,11,57,76,0,68,48,28,1.71,1.30,0.63,-0.39,8818.90
TTM,0.55,0.43,0,-0.01,20101028,20110806,3,7,54,64,0,61,44,20,2.20,1.35,0.65,-0.42,6220.70
TWC,0.75,0.49,0.04,0.01,20101028,20110806,14,15,40,69,0,47,44,25,1.76,1.34,0.89,-0.50,11606.80
TWX,0.99,0.25,0,0.02,20100706,20110806,23,23,90,136,0,62,84,52,1.62,0.87,0.81,-0.27,11295.70
TXN,0.79,0.39,0.03,-0.02,20100706,20110806,7,6,87,100,0,95,65,35,1.86,2.39,0.66,-0.37,8442.30
TXT,0.71,0.39,0.02,0.01,20101028,20110806,3,4,46,53,0,52,35,18,1.94,1.53,0.59,-0.40,3100.40
TYC,0.71,0.21,0.03,0.02,20100706,20110806,28,25,48,101,0,54,62,39,1.59,0.52,0.54,-0.24,5368.90
UAL,0.55,0.49,0.02,0.01,20101028,20110806,2,7,46,55,0,55,39,16,2.44,1.54,0.74,-0.50,7829.20
UBS,0.83,0.07,0.01,0.02,20100706,20110806,34,15,49,98,0,15,49,49,1.00,0.38,0.34,-0.09,2018.50
UCO,0.55,0.43,0.03,0.02,20100706,20110806,9,18,9,36,0,17,26,10,2.60,1.06,1.44,-0.47,14696.60
UNG,0.63,0.25,0.01,0.01,20100706,20110806,0,1,83,84,0,84,52,32,1.63,4.77,0.38,-0.14,2644.00
UNH,1.11,0.45,0.02,0.02,20100706,20110806,7,4,66,77,0,47,45,32,1.41,2.92,1.09,-0.48,3787.80
UNP,0.59,0.37,0,0.02,20100706,20110806,54,52,31,137,0,81,73,64,1.14,0.79,1.35,-0.46,18883.00
UPS,0.55,0.45,0.02,0.01,20101028,20110806,7,12,46,65,0,64,35,30,1.17,1.06,0.68,-0.46,6642.10
USB,0.55,0.19,0.02,0.01,20100706,20110806,18,22,39,79,0,68,47,32,1.47,0.39,0.35,-0.20,3803.50
USO,1.11,0.47,0,0.02,20100706,20110806,12,6,97,115,0,53,71,44,1.61,3.45,0.86,-0.53,10428.30
UTX,1.07,0.39,0.01,0.01,20100706,20110806,23,11,46,80,0,12,43,37,1.16,1.42,1.24,-0.42,4612.20
UUP,0.71,0.11,0.01,0.01,20110214,20110806,1,1,39,41,0,41,25,16,1.56,1.29,0.17,-0.12,433.30
VIP,0.55,0.15,0,-0.01,20101028,20110806,9,17,49,75,0,74,51,24,2.13,0.39,0.23,-0.16,4284.30
VLO,0.99,0.47,0.02,0.01,20100706,20110806,5,5,86,96,0,74,56,40,1.40,2.95,0.83,-0.48,7962.40
VMW,0.95,0.27,0.03,-0.01,20101028,20110806,41,17,20,78,0,5,36,42,0.86,1.77,2.18,-0.31,19225.30
VNQ,0.55,0.45,0.02,0.02,20100706,20110806,15,12,71,98,0,94,59,39,1.51,1.58,0.76,-0.48,7741.40
VOD,0.55,0.49,0.02,-0.02,20100706,20110806,0,0,55,55,0,55,36,19,1.89,0.00,0.43,-0.25,2959.40
VRX,0.83,0.49,0.02,0.02,20101028,20110806,7,12,49,68,0,44,42,26,1.62,1.43,1.25,-0.51,10887.00
VSH,0.55,0.31,0.01,0.01,20101028,20110806,7,5,60,72,0,72,41,31,1.32,1.41,0.47,-0.32,2777.70
VTI,1.07,0.47,0.02,0.01,20101028,20110806,3,4,46,53,0,33,33,20,1.65,2.22,0.92,-0.49,5592.30
VWO,0.55,0.47,0.02,0.01,20100706,20110806,2,1,34,37,0,37,23,14,1.64,8.78,4.21,-0.48,6695.00
WAG,0.55,0.35,0,-0.02,20100706,20110806,7,9,56,72,0,71,45,27,1.67,1.13,0.53,-0.33,6139.50
WDC,0.79,0.45,0.04,0.01,20100706,20110806,6,9,36,51,0,30,30,21,1.43,1.36,1.05,-0.46,7436.00
WEN,0.55,0.27,0.01,0.01,20100706,20110806,0,1,103,104,0,104,63,41,1.54,3.03,0.41,-0.18,983.00
WFC,0.55,0.37,0,0.01,20100706,20110806,12,8,81,101,0,101,63,38,1.66,1.90,0.80,-0.38,7183.80
WFR,0.67,0.39,0.04,0.01,20100706,20110806,0,1,65,66,0,66,48,18,2.67,6.59,0.59,-0.27,5023.40
WFT,0.91,0.31,0.02,0.01,20100706,20110806,12,8,47,67,0,45,39,28,1.39,1.16,0.60,-0.32,3531.60
WIN,0.55,0.13,0.01,0.01,20100706,20110806,2,4,99,105,0,105,63,42,1.50,1.05,0.20,-0.14,2258.30
WLP,0.55,0.47,0,0.02,20101028,20110806,14,25,43,82,0,69,51,31,1.65,0.99,0.93,-0.49,15741.70
WLT,0.87,0.41,0.01,0,20101028,20110806,29,14,8,51,0,7,18,33,0.55,1.64,3.22,-0.49,10513.90
WMB,0.87,0.33,0.02,0,20100706,20110806,11,10,64,85,0,66,58,27,2.15,1.17,0.78,-0.33,5986.80
WMT,0.55,0.35,0.02,0.01,20100706,20110806,4,10,50,64,0,64,43,21,2.05,0.95,0.53,-0.36,6403.80
WNR,0.67,0.41,0,-0.01,20101028,20110806,13,14,49,76,0,72,47,29,1.62,1.05,0.66,-0.40,7479.40
WYN,0.55,0.39,0,0.01,20101028,20110806,10,17,67,94,0,94,55,39,1.41,0.98,0.59,-0.41,8940.40
XCO,0.55,0.27,0.02,0.01,20100706,20110806,4,8,71,83,0,82,55,28,1.96,0.99,0.41,-0.28,5121.10
XEL,0.71,0.15,0.02,0,20101028,20110806,3,5,42,50,0,50,30,20,1.50,0.55,0.23,-0.15,1419.50
XHB,0.55,0.27,0,0.02,20100706,20110806,7,4,131,142,0,142,85,57,1.49,2.57,0.41,-0.29,3781.40
XLB,0.55,0.35,0,-0.01,20100706,20110806,4,10,61,75,0,75,43,32,1.34,0.99,0.56,-0.34,5851.80
XLE,1.11,0.21,0.04,-0.04,20100706,20110806,16,5,20,41,0,0,23,18,1.28,2.18,1.58,-0.17,7944.10
XLF,0.55,0.21,0.02,0.01,20100706,20110806,1,2,62,65,0,65,41,24,1.71,1.59,0.32,-0.22,1156.00
XLI,0.55,0.49,0.02,0.01,20100706,20110806,0,1,76,77,0,77,46,31,1.48,6.94,0.74,-0.31,2396.30
XLK,0.71,0.21,0.02,0.01,20100706,20110806,5,6,76,87,0,87,53,34,1.56,1.04,0.32,-0.22,3208.70
XLP,0.63,0.19,0.01,0.01,20100706,20110806,4,7,97,108,0,108,68,40,1.70,0.97,0.29,-0.20,3949.30
XLU,0.79,0.25,0.02,0.01,20100706,20110806,0,4,56,60,0,57,34,26,1.31,1.05,0.39,-0.16,2519.00
XLV,0.55,0.41,0.02,-0.02,20100706,20110806,0,1,36,37,0,37,26,11,2.36,3.67,0.62,-0.16,2741.50
XLY,0.55,0.45,0.02,0.01,20100706,20110806,0,5,73,78,0,78,48,30,1.60,2.04,0.68,-0.34,7178.90
XME,1.03,0.41,0.02,-0.04,20100706,20110806,36,18,38,92,0,12,52,40,1.30,1.83,1.72,-0.40,19083.40
XOM,0.71,0.13,0.01,0.01,20100706,20110806,35,29,9,73,0,21,37,36,1.03,0.46,0.99,-0.62,7620.80
XOP,0.63,0.31,0.02,-0.01,20100706,20110806,24,18,40,82,0,58,43,39,1.10,0.72,0.50,-0.30,4104.40
XRT,0.55,0.35,0.02,-0.02,20100706,20110806,9,13,38,60,0,58,40,20,2.00,0.79,0.54,-0.34,6075.20
XRU,0.55,0.27,0,0.01,20110214,20110806,1,2,2,5,0,5,4,1,4.00,1.05,1.20,0.00,2089.00
XRX,0.63,0.19,0.02,0.01,20100706,20110806,3,2,49,54,0,54,37,17,2.18,1.64,0.29,-0.20,1559.20
YGE,0.55,0.39,0.02,0.02,20101028,20110806,1,2,51,54,0,54,37,17,2.18,2.74,0.59,-0.41,3853.10
YUM,0.75,0.41,0.01,0.02,20100706,20110806,13,13,94,120,0,103,62,58,1.07,1.45,0.82,-0.43,6909.10
AAPL,1.03,0.49,0.04,0,20100706,20110806,38,10,21,69,0,0,28,41,0.68,5.77,5.08,-1.09,37563.40
ACAS,0.71,0.11,0.02,0.01,20100706,20110806,15,20,69,104,0,85,65,39,1.67,0.31,0.21,-0.13,3326.40
ADBE,0.55,0.31,0,0.01,20100706,20110806,19,23,59,101,0,98,63,38,1.66,0.74,0.50,-0.32,8568.20
ADSK,0.55,0.39,0.02,0.01,20100706,20110806,14,9,62,85,0,83,48,37,1.30,1.32,0.59,-0.40,3886.10
AGNC,0.71,0.17,0.03,0.01,20101028,20110806,3,5,49,57,0,50,40,17,2.35,0.72,0.31,-0.18,2242.20
AKAM,1.03,0.25,0.02,0.01,20100706,20110806,28,7,31,66,0,5,29,37,0.78,2.11,1.74,-0.27,6493.50
ALTR,1.03,0.41,0.01,0.01,20100706,20110806,10,5,71,86,0,35,50,36,1.39,2.94,1.03,-0.42,6853.40
AMAT,0.55,0.27,0.01,-0.02,20100706,20110806,0,0,46,46,0,46,27,19,1.42,0.00,0.30,-0.17,1213.40
AMGN,0.55,0.41,0.02,0.02,20100706,20110806,10,15,56,81,0,80,52,29,1.79,1.07,0.72,-0.43,9124.60
AMRN,1.11,0.43,0.02,0.01,20101028,20110806,2,10,46,58,0,46,39,19,2.05,1.01,0.94,-0.44,7586.50
AMTD,0.55,0.17,0.02,0.02,20100706,20110806,11,14,54,79,0,72,43,36,1.19,0.45,0.31,-0.20,2756.70
AMZN,0.63,0.33,0,0.01,20100706,20110806,68,48,11,127,0,42,58,69,0.84,1.01,2.37,-0.37,24823.60
APKT,1.07,0.39,0,0,20101028,20110806,23,9,23,55,0,1,29,26,1.12,3.35,3.47,-0.43,20832.70
APOL,0.99,0.35,0.03,0.01,20100706,20110806,14,7,44,65,0,8,36,29,1.24,1.72,1.25,-0.37,5374.40
ARIA,0.55,0.49,0.01,0,20101028,20110806,0,0,33,33,0,33,20,13,1.54,0.00,0.50,-0.26,1602.30
ARMH,0.67,0.35,0.01,0.01,20101028,20110806,7,9,35,51,0,37,26,25,1.04,0.94,0.73,-0.36,3735.80
ARNA,0.67,0.31,0.01,0.01,20100706,20110806,0,2,75,77,0,77,44,33,1.33,1.29,0.47,-0.14,1404.10
ARUN,0.63,0.43,0,0,20101028,20110806,10,12,27,49,0,39,28,21,1.33,0.87,0.93,-0.44,5003.40
ASML,0.87,0.43,0.02,0,20101028,20110806,2,4,36,42,0,17,29,13,2.23,1.82,0.97,-0.43,5550.80
ATHR,0.67,0.43,0.02,0.01,20101028,20110806,0,3,14,17,0,14,15,2,7.50,1.18,0.80,-0.12,3356.20
ATML,0.55,0.49,0,0.02,20100706,20110806,0,0,116,116,0,116,68,48,1.42,0.00,0.58,-0.26,3566.60
ATPG,0.87,0.45,0,0.01,20100706,20110806,14,8,76,98,0,87,54,44,1.23,1.94,0.85,-0.47,5356.20
ATVI,0.55,0.27,0.02,0,20100706,20110806,0,0,53,53,0,53,27,26,1.04,0.00,0.27,-0.13,1202.70
AVGO,0.55,0.49,0.02,0,20101028,20110806,5,7,48,60,0,60,38,22,1.73,1.75,0.76,-0.50,7566.60
BBBY,0.55,0.43,0.03,0.01,20100706,20110806,7,8,42,57,0,56,38,19,2.00,1.23,0.66,-0.44,4571.90
BBVA,0.67,0.07,0.03,0.01,20100706,20110806,18,16,28,62,0,17,35,27,1.30,0.22,0.26,-0.09,1772.20
BEXP,1.03,0.17,0.04,0,20100706,20110806,22,17,23,62,0,3,36,26,1.38,0.78,0.99,-0.19,9113.20
BIDU,1.03,0.45,0,0.01,20100706,20110806,60,16,41,117,0,12,50,67,0.75,3.76,4.00,-0.51,31389.00
BPOP,0.55,0.09,0.01,0.01,20100706,20110806,6,3,77,86,0,86,47,39,1.21,0.65,0.15,-0.10,460.60
BRCD,0.67,0.09,0.01,0.02,20100706,20110806,9,11,94,114,0,111,63,51,1.24,0.33,0.14,-0.11,834.20
BRCM,0.55,0.49,0.02,0,20100706,20110806,9,8,49,66,0,65,35,31,1.13,1.53,0.74,-0.49,5095.90
BUCY,0.87,0.29,0.02,0.01,20100706,20110806,18,12,52,82,0,39,46,36,1.28,1.31,2.37,-0.32,9451.20
CDNS,0.55,0.15,0.02,0.01,20100706,20110806,4,5,79,88,0,88,56,32,1.75,0.82,0.23,-0.16,2143.50
CELG,0.55,0.49,0.01,0,20100706,20110806,10,14,41,65,0,65,41,24,1.71,1.20,0.80,-0.49,9718.10
CENX,0.63,0.43,0.02,0,20100706,20110806,1,2,75,78,0,78,50,28,1.79,3.76,0.65,-0.43,3800.20
CHKP,0.55,0.35,0.01,0.01,20100706,20110806,8,15,45,68,0,65,41,27,1.52,0.82,0.55,-0.36,7071.50
CIEN,0.55,0.47,0.01,0,20100706,20110806,7,8,79,94,0,94,45,49,0.92,1.59,0.71,-0.48,4590.80
COCO,0.71,0.27,0.01,-0.01,20100706,20110806,1,6,74,81,0,77,55,26,2.12,1.11,0.41,-0.26,4942.10
COST,0.71,0.45,0,0.01,20101028,20110806,6,15,47,68,0,59,45,23,1.96,1.13,0.88,-0.46,11785.70
CPWR,0.91,0.15,0.02,0,20101028,20110806,4,3,41,48,0,45,30,18,1.67,0.88,0.23,-0.15,1398.00
CREE,0.59,0.33,0.01,0.01,20101028,20110806,17,19,29,65,0,45,36,29,1.24,0.79,1.12,-0.35,8121.00
CROX,0.55,0.49,0.02,0.01,20100706,20110806,1,1,66,68,0,68,45,23,1.96,8.91,0.74,-0.50,5551.90
CRUS,0.91,0.47,0,0.02,20100706,20110806,8,5,61,74,0,59,34,40,0.85,2.44,0.94,-0.49,4385.00
CSCO,0.55,0.39,0.01,-0.02,20100706,20110806,1,1,57,59,0,59,40,19,2.11,4.72,0.59,-0.37,2828.90
CSTR,0.63,0.43,0,0,20101028,20110806,19,25,29,73,0,44,47,26,1.81,1.03,1.43,-0.46,16038.40
CTRP,0.99,0.37,0.02,-0.02,20101028,20110806,14,12,37,63,0,10,41,22,1.86,1.51,1.60,-0.38,12048.30
CTSH,1.11,0.31,0.02,0.01,20101028,20110806,15,9,31,55,0,5,32,23,1.39,1.77,2.16,-0.34,10168.80
CTXS,0.55,0.39,0.02,0.01,20101028,20110806,23,28,13,64,0,41,39,25,1.56,0.80,1.38,-0.45,12775.60
DELL,0.63,0.25,0.03,0,20100706,20110806,1,1,56,58,0,58,37,21,1.76,4.84,0.38,-0.25,3378.10
DISH,0.55,0.39,0.01,0.01,20101028,20110806,2,3,55,60,0,60,29,31,0.94,1.92,0.59,-0.40,1878.30
DNDN,0.55,0.45,0,0.01,20100706,20110806,21,24,66,111,0,96,69,42,1.64,1.14,1.22,-0.47,14844.80
DRYS,0.55,0.21,0.01,0.01,20100706,20110806,0,1,83,84,0,84,55,29,1.90,2.82,0.32,-0.13,1433.00
EBAY,0.55,0.45,0.02,0.02,20100706,20110806,8,7,81,96,0,96,57,39,1.46,1.98,0.68,-0.47,6155.50
ENTR,0.59,0.05,0.02,0.01,20101028,20110806,20,31,13,64,0,32,41,23,1.78,0.13,0.28,-0.06,2624.70
ERIC,0.55,0.39,0.02,0.01,20100706,20110806,0,0,64,64,0,64,41,23,1.78,0.00,0.28,-0.14,1476.80
ERTS,0.55,0.49,0.02,-0.02,20101028,20110806,0,0,31,31,0,31,23,8,2.88,0.00,0.57,-0.35,3299.50
ESRX,0.55,0.37,0.01,0,20101028,20110806,7,13,21,41,0,39,25,16,1.56,0.68,0.60,-0.37,4959.70
ETFC,0.67,0.11,0,0.01,20101028,20110806,19,19,38,76,0,58,39,37,1.05,0.24,0.24,-0.12,1228.80
EXEL,0.55,0.49,0.01,0.01,20101028,20110806,1,2,71,74,0,74,51,23,2.22,3.97,0.74,-0.50,4854.00
EXPE,0.55,0.43,0.03,0,20100706,20110806,3,4,51,58,0,58,41,17,2.41,2.08,0.66,-0.43,5421.90
FFIV,0.67,0.41,0.02,-0.01,20101028,20110806,20,19,9,48,0,13,25,23,1.09,1.22,2.37,-0.50,14720.50
FITB,0.63,0.25,0.01,0.02,20100706,20110806,3,6,102,111,0,110,63,48,1.31,1.45,0.38,-0.27,3469.90
FLEX,0.55,0.27,0.02,0.01,20100706,20110806,0,0,77,77,0,77,45,32,1.41,0.00,0.19,-0.11,1324.30
FNFG,0.55,0.27,0.02,0.01,20101028,20110806,1,1,56,58,0,58,38,20,1.90,2.71,0.41,-0.28,1258.00
FNSR,0.75,0.49,0.02,0.01,20101028,20110806,6,12,35,53,0,35,36,17,2.12,1.42,1.38,-0.51,12539.20
FWLT,0.79,0.17,0.01,0.01,20101028,20110806,26,12,26,64,0,24,35,29,1.21,0.85,0.99,-0.19,5117.30
GENZ,1.11,0.41,0.01,0.01,20100706,20110806,7,6,44,57,0,34,35,22,1.59,1.52,1.30,-0.42,4366.50
GILD,0.55,0.39,0.01,-0.01,20100706,20110806,12,13,75,100,0,100,58,42,1.38,1.23,0.69,-0.39,7214.40
GMCR,1.11,0.41,0,0,20101028,20110806,17,9,38,64,0,5,37,27,1.37,2.18,1.49,-0.42,11483.50
GOOG,0.91,0.49,0.03,0.02,20101028,20110806,36,14,3,53,0,1,17,36,0.47,4.84,9.19,-0.77,48793.30
HBAN,0.55,0.13,0.02,0,20100706,20110806,5,3,69,77,0,77,53,24,2.21,1.04,0.20,-0.13,1579.90
HCBK,0.55,0.39,0.03,0.01,20100706,20110806,0,0,39,39,0,39,24,15,1.60,0.00,0.43,-0.15,1505.30
HERO,0.55,0.49,0.01,0,20100706,20110806,0,1,81,82,0,82,54,28,1.93,5.10,0.74,-0.29,2651.60
HGSI,1.11,0.43,0,-0.01,20100706,20110806,9,10,63,82,0,44,46,36,1.28,1.32,0.93,-0.42,5650.60
HOLX,0.55,0.25,0.02,-0.01,20101028,20110806,1,1,36,38,0,38,27,11,2.45,2.88,0.38,-0.24,2175.60
IDTI,0.55,0.25,0.01,0.01,20101028,20110806,0,1,76,77,0,77,50,27,1.85,3.99,0.38,-0.18,2193.50
INTC,0.55,0.35,0.03,0.02,20100706,20110806,0,0,87,87,0,87,59,28,2.11,0.00,0.44,-0.26,5093.90
INTU,0.55,0.49,0,0.01,20101028,20110806,5,7,42,54,0,54,31,23,1.35,1.47,0.75,-0.51,5507.90
ISIL,0.55,0.45,0.02,0.01,20101028,20110806,0,1,59,60,0,60,43,17,2.53,5.03,0.68,-0.23,3680.60
ITUB,0.55,0.49,0.01,0,20100706,20110806,2,5,82,89,0,89,55,34,1.62,2.68,0.74,-0.49,8189.60
JASO,0.83,0.19,0.01,0.01,20100706,20110806,4,7,73,84,0,81,53,31,1.71,0.76,0.37,-0.20,2815.30
JBLU,0.83,0.11,0.01,0.01,20100706,20110806,16,13,82,111,0,102,66,45,1.47,0.39,0.18,-0.12,1884.70
JDSU,0.99,0.33,0.04,0.01,20100706,20110806,6,2,46,54,0,34,37,17,2.18,3.98,0.77,-0.34,4674.40
JNPR,0.79,0.31,0.02,0.01,20100706,20110806,18,11,35,64,0,32,42,22,1.91,1.26,1.09,-0.33,7723.40
KLAC,0.91,0.41,0.02,-0.05,20101028,20110806,6,7,15,28,0,11,20,8,2.50,1.29,1.21,-0.37,6729.10
LLNW,0.55,0.35,0,0.01,20101028,20110806,0,2,86,88,0,88,55,33,1.67,3.50,0.53,-0.32,4356.70
LLTC,0.99,0.15,0.01,0.02,20100706,20110806,19,8,34,61,0,14,32,29,1.10,0.79,0.51,-0.17,2257.20
LNKD,0.55,0.49,0,-0.05,20110519,20110806,6,6,3,15,0,8,9,6,1.50,1.12,1.14,-0.48,3954.90
LRCX,0.55,0.49,0,-0.01,20101028,20110806,14,26,39,79,0,72,55,24,2.29,1.04,1.10,-0.49,18484.20
LULU,0.71,0.41,0,0.02,20101028,20110806,37,30,22,89,0,26,48,41,1.17,1.21,1.96,-0.48,19688.00
LVLT,0.55,0.27,0.01,0.01,20100706,20110806,0,0,73,73,0,73,44,29,1.52,0.00,0.10,-0.12,503.90
MDRX,0.55,0.23,0.01,-0.02,20101028,20110806,6,7,44,57,0,57,44,13,3.38,0.96,0.35,-0.21,5038.60
MIPS,1.11,0.19,0.03,0,20101028,20110806,4,3,17,24,0,5,16,8,2.00,1.01,0.72,-0.19,1970.10
MPEL,0.55,0.49,0.01,0.01,20101028,20110806,1,3,56,60,0,60,36,24,1.50,1.96,0.74,-0.50,3571.80
MRVL,0.63,0.29,0.01,0,20100706,20110806,11,11,83,105,0,103,65,40,1.63,1.10,0.51,-0.29,6128.70
MSFT,0.55,0.37,0.03,0,20100706,20110806,2,2,51,55,0,55,32,23,1.39,3.03,0.56,-0.37,3452.20
MXIM,0.87,0.37,0.01,0,20101028,20110806,1,8,58,67,0,62,46,21,2.19,1.22,0.63,-0.37,7644.20
NDAQ,0.67,0.29,0.02,0.01,20101028,20110806,6,6,57,69,0,60,45,24,1.88,1.53,0.64,-0.30,5465.70
NFLX,1.27,0.29,0.01,0,20101028,20110806,39,4,16,59,0,0,20,39,0.51,11.52,6.70,-0.38,34722.40
NOVL,0.55,0.07,0.02,0.01,20101028,20110806,0,2,4,6,0,6,6,0,Infinity,0.19,0.11,0.00,361.00
NTAP,0.71,0.33,0,0.02,20100706,20110806,20,22,37,79,0,43,52,27,1.93,0.83,0.99,-0.35,10303.50
NUAN,0.55,0.45,0.02,0.02,20100706,20110806,2,1,68,71,0,71,43,28,1.54,6.46,0.68,-0.47,3201.40
NVDA,0.55,0.49,0.02,0.01,20100706,20110806,3,6,84,93,0,92,62,31,2.00,2.26,0.74,-0.50,8536.60
NWSA,1.07,0.17,0.04,0.02,20100706,20110806,3,5,47,55,0,18,37,18,2.06,0.81,0.27,-0.19,2410.00
ONNN,0.91,0.17,0.02,0.01,20100706,20110806,5,7,76,88,0,74,52,36,1.44,0.73,0.32,-0.18,3062.00
ORCL,0.55,0.33,0.01,0.02,20100706,20110806,11,8,70,89,0,89,46,43,1.07,1.24,0.50,-0.35,2276.60
PAYX,0.71,0.25,0.02,0.01,20100706,20110806,11,12,72,95,0,91,51,44,1.16,0.75,0.43,-0.26,3954.60
PBCT,0.55,0.27,0,0.01,20100706,20110806,0,0,139,139,0,139,79,60,1.32,0.00,0.30,-0.17,2629.90
PCAR,0.55,0.37,0.02,0.02,20101028,20110806,18,25,37,80,0,65,51,29,1.76,0.76,0.78,-0.40,10169.40
PMCS,0.67,0.21,0.02,0.01,20101028,20110806,0,2,56,58,0,58,44,14,3.14,1.87,0.32,-0.10,2949.50
PTEN,0.99,0.49,0,0,20100706,20110806,3,7,84,94,0,75,59,35,1.69,2.32,1.02,-0.50,9432.60
PWER,0.55,0.19,0.02,0.01,20101028,20110806,8,7,34,49,0,46,33,16,2.06,0.63,0.29,-0.20,2005.30
QCOM,0.55,0.45,0.04,-0.02,20100706,20110806,13,9,58,80,0,72,48,32,1.50,1.60,0.78,-0.43,6020.60
QLGC,1.03,0.23,0.03,-0.01,20101028,20110806,3,7,37,47,0,34,33,14,2.36,0.79,0.50,-0.22,4242.00
QQQQ,0.63,0.45,0.02,0.02,20100706,20110806,5,4,32,41,0,41,25,16,1.56,1.64,1.05,-0.66,2866.80
RFMD,0.55,0.37,0.01,0.02,20100706,20110806,1,1,119,121,0,121,72,49,1.47,6.29,0.56,-0.39,2301.00
RIMM,0.63,0.41,0.04,0.01,20100706,20110806,23,24,41,88,0,43,53,35,1.51,1.14,1.40,-0.42,16211.70
RVBD,0.79,0.49,0.03,-0.05,20101028,20110806,13,8,37,58,0,31,40,18,2.22,2.04,1.12,-0.44,9765.30
SBIB,0.91,0.11,0.02,0.01,20101028,20110806,3,5,55,63,0,54,43,20,2.15,0.53,0.27,-0.12,1644.10
SBUX,0.75,0.39,0.02,0,20100706,20110806,7,8,61,76,0,67,45,31,1.45,1.53,0.65,-0.39,6108.90
SCHW,0.55,0.49,0,-0.01,20100706,20110806,0,1,84,85,0,85,51,34,1.50,7.08,0.74,-0.30,2891.90
SINA,0.75,0.41,0,-0.01,20101028,20110806,30,19,15,64,0,17,32,32,1.00,1.51,2.40,-0.45,16189.20
SIVR,0.55,0.47,0.02,-0.04,20110214,20110806,4,5,19,28,0,24,21,7,3.00,1.52,0.77,-0.44,5388.10
SNDK,0.63,0.29,0.01,0,20100706,20110806,27,19,22,68,0,29,34,34,1.00,0.83,1.31,-0.30,7271.10
SOLR,0.55,0.39,0.01,0,20101028,20110806,0,3,39,42,0,42,27,15,1.80,1.65,0.59,-0.21,3545.80
SPLS,0.63,0.31,0.02,0.01,20100706,20110806,0,2,94,96,0,96,61,35,1.74,3.76,0.47,-0.23,3928.40
SQNM,0.91,0.13,0.02,0.01,20100706,20110806,10,11,71,92,0,73,55,37,1.49,0.50,0.30,-0.14,2987.50
SSCC,1.11,0.49,0,0.02,20101028,20110806,1,8,54,63,0,51,43,20,2.15,1.59,0.88,-0.48,9395.80
STLD,0.55,0.47,0.02,0.01,20100706,20110806,1,2,89,92,0,92,53,39,1.36,4.23,0.71,-0.48,3326.50
SVNT,0.55,0.27,0.01,0.01,20101028,20110806,3,3,58,64,0,63,41,23,1.78,1.61,0.41,-0.28,2449.10
SWFT,0.63,0.39,0.03,0.02,20101028,20110806,2,4,39,45,0,45,30,15,2.00,1.81,0.60,-0.41,4966.60
SWKS,0.83,0.49,0,-0.01,20100706,20110806,9,10,79,98,0,82,57,41,1.39,2.11,0.96,-0.49,12369.60
SYMC,0.55,0.17,0.02,0.01,20100706,20110806,5,7,61,73,0,73,42,31,1.35,0.66,0.26,-0.18,1480.00
TEVA,0.55,0.47,0.02,0.01,20100706,20110806,8,10,55,73,0,72,44,29,1.52,1.38,0.71,-0.48,7444.40
TIBX,0.71,0.45,0.02,0,20101028,20110806,8,7,40,55,0,48,32,23,1.39,1.33,0.79,-0.45,4227.10
TIVO,0.55,0.49,0.02,0.01,20101028,20110806,0,0,51,51,0,51,30,21,1.43,0.00,0.41,-0.28,1363.50
TLAB,0.55,0.27,0.01,0.01,20100706,20110806,0,0,95,95,0,95,62,33,1.88,0.00,0.21,-0.14,2108.70
TQNT,1.11,0.35,0.03,0.01,20100706,20110806,0,3,71,74,0,62,46,28,1.64,2.80,0.65,-0.31,5039.10
URBN,0.55,0.37,0.01,0,20101028,20110806,6,9,41,56,0,54,39,17,2.29,1.08,0.57,-0.37,5816.90
VALE,0.55,0.21,0.02,0,20100706,20110806,13,20,35,68,0,44,44,24,1.83,0.49,0.56,-0.21,6072.20
VECO,1.23,0.39,0.01,0.01,20101028,20110806,11,4,21,36,0,0,23,13,1.77,3.66,2.19,-0.42,9745.90
VMED,0.71,0.43,0.01,0.01,20101028,20110806,0,3,50,53,0,53,30,23,1.30,2.09,0.65,-0.36,4068.20
VRSN,0.67,0.45,0.02,0,20100706,20110806,4,6,64,74,0,74,44,30,1.47,1.71,0.68,-0.45,5839.90
VRTX,0.67,0.49,0.01,0.01,20101028,20110806,10,14,40,64,0,57,41,23,1.78,1.14,0.85,-0.50,8814.00
VVUS,0.55,0.39,0.02,0.01,20100706,20110806,0,0,48,48,0,48,30,18,1.67,0.00,0.35,-0.14,1828.70
WYNN,0.75,0.31,0.04,0.02,20101028,20110806,34,21,9,64,0,10,28,36,0.78,1.54,2.79,-0.39,20539.00
XLNX,0.67,0.27,0.02,0.01,20100706,20110806,10,13,38,61,0,51,35,26,1.35,0.64,0.51,-0.28,3949.20
YHOO,0.55,0.25,0,0,20100706,20110806,7,7,88,102,0,102,57,45,1.27,1.06,0.44,-0.25,3251.70
ZION,0.71,0.47,0,0.02,20100706,20110806,3,6,88,97,0,95,53,44,1.20,2.22,0.71,-0.49,5652.90
CMCSA,0.75,0.15,0.02,0,20100706,20110806,17,23,39,79,0,50,48,31,1.55,0.33,0.43,-0.15,4176.10
LINTA,0.55,0.37,0.02,0.01,20100706,20110806,0,2,62,64,0,64,36,28,1.29,2.44,0.56,-0.15,2473.00
PBR.A,0.55,0.37,0,0.01,20100706,20110806,9,16,64,89,0,89,54,35,1.54,1.06,0.56,-0.38,9803.00
VIA.B,0.99,0.39,0.02,0.01,20100706,20110806,16,10,85,111,0,63,73,38,1.92,1.83,0.89,-0.68,8406.00
